Rk,Player,Pos,Age,Tm,G,GS,MP,FG,FGA,FG_,_3P,_3PA,_3P_,_2P,_2PA,_2P_,eFG_,FT,FTA,FT_,ORB,DRB,TRB,AST,STL,BLK,TOV,PF,PTS
93,Wendell Carter\cartewe01,C,19,CHI,44,44,1110,180,371,0.485,6,32,0.188,174,339,0.513,0.493,89,112,0.795,87,220,307,78,26,58,65,152,455
11,Jarrett Allen\allenja01,C,20,BRK,79,79,2074,335,564,0.594,6,45,0.133,329,519,0.634,0.599,196,276,0.71,192,467,659,108,43,118,102,182,872
17,Ike Anigbogu\anigbik01,C,20,IND,3,0,6,0,3,0.0,0,0,,0,3,0.0,0.0,0,0,,1,2,3,1,0,1,1,0,0
25,Deandre Ayton\aytonde01,C,20,PHO,71,70,2183,509,870,0.585,0,4,0.0,509,866,0.588,0.585,141,189,0.746,223,506,729,125,61,67,126,209,1159
31,Mohamed Bamba\bambamo01,C,20,ORL,47,1,766,117,243,0.481,21,70,0.3,96,173,0.555,0.525,37,63,0.587,64,169,233,39,13,64,43,102,292
425,Mitchell Robinson\robinmi01,C,20,NYK,64,17,1302,194,279,0.695,0,0,,194,279,0.695,0.695,78,131,0.595,173,231,404,37,51,158,34,210,466
5,Bam Adebayo\adebaba01,C,21,MIA,80,27,1872,268,468,0.573,2,13,0.154,266,455,0.585,0.575,162,220,0.736,164,418,582,182,69,63,119,203,700
64,Tony Bradley\bradlto01,C,21,UTA,2,0,12,1,4,0.25,0,0,,1,4,0.25,0.25,0,0,,2,3,5,0,0,0,1,2,2
79,Thomas Bryant\bryanth01,C,21,WAS,71,52,1479,303,495,0.612,32,97,0.33,271,398,0.681,0.644,106,136,0.779,113,335,448,90,25,67,59,125,744
109,Zach Collins\colliza01,C,21,POR,75,0,1330,184,392,0.469,39,119,0.328,145,273,0.531,0.519,92,124,0.742,105,211,316,70,25,64,75,170,499
129,Tyler Davis\davisty01,C,21,OKC,1,0,1,0,1,0.0,0,0,,0,1,0.0,0.0,0,0,,1,0,1,0,0,0,0,0,0
240,Isaac Humphries\humphis01,C,21,ATL,4,1,55,5,20,0.25,3,11,0.273,2,9,0.222,0.325,0,0,,3,7,10,0,1,0,0,6,13
323,Thon Maker\makerth01,C,21,MIL,35,0,409,59,134,0.44,26,78,0.333,33,56,0.589,0.537,20,37,0.541,17,79,96,18,10,18,9,55,164
396,Justin Patton\pattoju01,C,21,PHI,3,0,21,2,7,0.286,0,2,0.0,2,5,0.4,0.286,1,2,0.5,2,4,6,3,2,0,0,5,5
492,Moritz Wagner\wagnemo01,C,21,LAL,42,5,430,68,163,0.417,22,74,0.297,46,89,0.517,0.485,42,51,0.824,16,65,81,24,11,13,38,56,200
515,Robert Williams\williro04,C,21,BOS,31,1,254,35,48,0.729,0,0,,35,48,0.729,0.729,9,15,0.6,24,46,70,6,8,37,9,30,79
528,Ivica Zubac\zubaciv01,C,21,TOT,58,36,1010,202,366,0.552,0,0,,202,366,0.552,0.552,99,124,0.798,111,240,351,61,14,48,67,135,503
528,Ivica Zubac\zubaciv01,C,21,LAL,33,12,516,112,193,0.58,0,0,,112,193,0.58,0.58,57,66,0.864,54,108,162,25,4,27,33,73,281
528,Ivica Zubac\zubaciv01,C,21,LAC,25,24,494,90,173,0.52,0,0,,90,173,0.52,0.52,42,58,0.724,57,132,189,36,10,21,34,62,222
127,Deyonta Davis\davisde01,C,22,ATL,8,0,115,15,22,0.682,0,1,0.0,15,21,0.714,0.682,4,8,0.5,9,26,35,5,3,5,3,12,34
308,Kevon Looney\looneke01,C,22,GSW,78,24,1452,212,336,0.631,1,10,0.1,211,326,0.647,0.632,65,105,0.619,190,220,410,118,45,53,51,207,490
432,Domantas Sabonis\sabondo01,C,22,IND,74,5,1838,413,700,0.59,9,17,0.529,404,683,0.592,0.596,208,291,0.715,186,504,690,212,48,30,160,239,1043
483,Myles Turner\turnemy01,C,22,IND,74,74,2119,380,780,0.487,76,196,0.388,304,584,0.521,0.536,148,201,0.736,101,430,531,115,60,199,100,195,984
503,Thomas Welsh\welshth01,C,22,DEN,11,0,36,7,13,0.538,3,7,0.429,4,6,0.667,0.654,1,2,0.5,0,4,4,5,0,0,1,3,18
527,Ante Zizic\zizican01,C,22,CLE,58,24,1061,180,325,0.554,0,0,,180,325,0.554,0.554,93,132,0.705,106,210,316,52,13,22,61,111,453
268,Nikola Jokic\jokicni01,C,23,DEN,78,78,2451,602,1174,0.513,82,263,0.312,520,911,0.571,0.548,287,348,0.825,223,623,846,576,104,54,243,218,1573
269,Damian Jones\jonesda03,C,23,GSW,24,22,410,53,74,0.716,0,0,,53,74,0.716,0.716,24,37,0.649,31,44,75,28,12,25,16,63,130
384,Jahlil Okafor\okafoja01,C,23,NOP,58,23,897,197,338,0.583,1,4,0.25,196,334,0.587,0.584,59,87,0.678,81,190,271,39,13,40,49,94,454
404,Jakob Poeltl\poeltja01,C,23,SAS,76,23,1253,185,287,0.645,0,0,,185,287,0.645,0.645,49,92,0.533,177,231,408,91,29,67,48,122,419
478,Karl-Anthony Towns\townska01,C,23,MIN,77,77,2545,681,1314,0.518,142,355,0.4,539,959,0.562,0.572,376,450,0.836,263,691,954,259,67,125,240,292,1880
511,Johnathan Williams\willijo04,C,23,LAL,23,0,343,60,101,0.594,0,2,0.0,60,99,0.606,0.594,25,46,0.543,43,46,89,10,6,7,14,59,145
44,Jordan Bell\belljo01,C,24,GSW,66,2,745,88,176,0.5,0,2,0.0,88,174,0.506,0.5,22,37,0.595,49,121,170,71,20,50,38,77,198
89,Clint Capela\capelca01,C,24,HOU,66,66,2212,466,722,0.645,0,0,,466,722,0.645,0.645,164,257,0.638,295,543,838,93,44,99,91,166,1096
132,Angel Delgado\delgaan01,C,24,LAC,2,0,15,1,5,0.2,0,0,,1,5,0.2,0.2,1,2,0.5,2,2,4,0,1,0,0,2,3
155,Joel Embiid\embiijo01,C,24,PHI,64,64,2154,580,1199,0.484,79,263,0.3,501,936,0.535,0.517,522,649,0.804,160,711,871,234,46,122,226,211,1761
221,Willy Hernangomez\hernawi01,C,24,CHO,57,3,809,153,294,0.52,15,38,0.395,138,256,0.539,0.546,100,144,0.694,117,192,309,59,16,20,58,98,421
375,Nerlens Noel\noelne01,C,24,OKC,75,2,1034,159,270,0.589,0,0,,159,270,0.589,0.589,54,79,0.684,126,195,321,43,65,94,47,165,372
379,Jusuf Nurkic\nurkiju01,C,24,POR,72,72,1974,420,826,0.508,3,29,0.103,417,797,0.523,0.51,282,365,0.773,243,505,748,233,71,103,168,250,1125
4,Steven Adams\adamsst01,C,25,OKC,78,78,2621,477,793,0.602,0,2,0.0,477,791,0.603,0.602,142,284,0.5,381,364,745,123,117,75,135,202,1096
97,Willie Cauley-Stein\caulewi01,C,25,SAC,80,80,2195,409,738,0.554,1,2,0.5,408,736,0.554,0.555,138,252,0.548,179,494,673,194,96,51,84,225,957
126,Anthony Davis\davisan02,C,25,NOP,56,56,1850,530,1026,0.517,48,145,0.331,482,881,0.547,0.54,344,433,0.794,174,498,672,218,88,135,112,132,1452
147,Andre Drummond\drumman01,C,25,DET,77,77,2581,545,1026,0.531,5,38,0.132,540,988,0.547,0.534,235,399,0.589,411,786,1197,108,129,135,167,263,1330
208,Montrezl Harrell\harremo01,C,25,LAC,81,5,2137,536,875,0.613,3,17,0.176,533,858,0.621,0.614,262,408,0.642,181,348,529,157,70,109,130,254,1337
234,Richaun Holmes\holmeri01,C,25,PHO,70,4,1184,222,365,0.608,0,0,,222,365,0.608,0.608,128,175,0.731,115,216,331,60,42,79,52,194,572
277,Frank Kaminsky\kaminfr01,C,25,CHO,45,0,713,133,287,0.463,48,134,0.358,85,153,0.556,0.547,68,93,0.731,38,119,157,59,11,12,38,63,382
299,Alex Len\lenal01,C,25,ATL,76,30,1513,314,631,0.498,72,198,0.364,242,433,0.559,0.555,134,208,0.644,152,262,414,83,27,66,97,197,834
50,Khem Birch\birchkh01,C,26,ORL,49,0,620,89,147,0.605,0,1,0.0,89,146,0.61,0.605,57,81,0.704,77,107,184,36,18,29,20,67,235
51,Bismack Biyombo\biyombi01,C,26,CHO,52,30,735,85,151,0.563,0,0,,85,151,0.563,0.563,55,85,0.647,78,158,236,30,11,41,32,98,225
164,Cristiano Felicio\feliccr01,C,26,CHI,58,0,707,93,172,0.541,0,4,0.0,93,168,0.554,0.541,48,68,0.706,76,128,204,36,10,7,32,66,234
187,Rudy Gobert\goberru01,C,26,UTA,80,79,2542,469,700,0.67,0,0,,469,700,0.67,0.67,326,513,0.635,307,724,1031,160,65,185,130,230,1264
278,Enes Kanter\kanteen01,C,26,TOT,66,30,1603,367,670,0.548,9,33,0.273,358,637,0.562,0.554,150,191,0.785,251,392,643,114,31,26,115,163,893
278,Enes Kanter\kanteen01,C,26,NYK,44,23,1128,251,468,0.536,7,22,0.318,244,446,0.547,0.544,105,129,0.814,171,290,461,84,18,17,79,106,614
278,Enes Kanter\kanteen01,C,26,POR,22,7,475,116,202,0.574,2,11,0.182,114,191,0.597,0.579,45,62,0.726,80,102,182,30,13,9,36,57,279
301,Meyers Leonard\leoname01,C,26,POR,60,1,836,124,229,0.541,49,109,0.45,75,120,0.625,0.648,41,49,0.837,45,177,222,72,13,9,40,101,338
370,Larry Nance\nancela02,C,26,CLE,66,29,1759,245,470,0.521,33,96,0.344,212,374,0.567,0.556,94,132,0.712,162,377,539,208,99,38,95,189,617
470,Daniel Theis\theisda01,C,26,BOS,65,2,895,145,265,0.547,26,67,0.388,119,198,0.601,0.596,56,76,0.737,86,136,222,67,21,42,33,160,372
486,Jonas Valanciunas\valanjo01,C,26,TOT,49,27,1091,301,538,0.559,14,48,0.292,287,490,0.586,0.572,147,185,0.795,106,313,419,70,19,53,90,146,763
486,Jonas Valanciunas\valanjo01,C,26,TOR,30,10,564,149,259,0.575,9,30,0.3,140,229,0.611,0.593,77,94,0.819,54,162,216,29,13,23,39,82,384
486,Jonas Valanciunas\valanjo01,C,26,MEM,19,17,527,152,279,0.545,5,18,0.278,147,261,0.563,0.554,70,91,0.769,52,151,203,41,6,30,51,64,379
525,Cody Zeller\zelleco01,C,26,CHO,49,47,1243,190,345,0.551,6,22,0.273,184,323,0.57,0.559,111,141,0.787,110,223,333,102,38,41,62,164,497
163,Derrick Favors\favorde01,C,27,UTA,75,69,1744,356,607,0.586,17,77,0.221,339,530,0.64,0.6,152,225,0.676,204,349,553,88,55,106,81,160,881
408,Dwight Powell\poweldw01,C,27,DAL,75,20,1602,286,478,0.598,39,125,0.312,247,353,0.7,0.639,186,241,0.772,130,259,389,107,44,47,64,193,797
475,Tristan Thompson\thomptr01,C,27,CLE,43,40,1198,201,380,0.529,0,0,,201,380,0.529,0.529,68,106,0.642,173,265,438,86,28,16,59,89,470
115,DeMarcus Cousins\couside01,C,28,GSW,29,29,736,171,353,0.484,25,90,0.278,146,263,0.555,0.52,100,134,0.746,43,192,235,101,39,43,69,107,467
219,John Henson\hensojo01,C,28,MIL,14,0,188,31,67,0.463,11,31,0.355,20,36,0.556,0.545,6,10,0.6,16,55,71,14,7,11,12,16,79
355,Greg Monroe\monrogr01,C,28,TOT,41,2,438,81,171,0.474,0,4,0.0,81,167,0.485,0.474,36,62,0.581,64,97,161,19,14,8,31,62,198
355,Greg Monroe\monrogr01,C,28,TOR,38,2,423,74,161,0.46,0,4,0.0,74,157,0.471,0.46,35,61,0.574,60,96,156,16,13,8,31,61,183
355,Greg Monroe\monrogr01,C,28,BOS,2,0,5,3,5,0.6,0,0,,3,5,0.6,0.6,0,0,,3,0,3,1,0,0,0,0,6
355,Greg Monroe\monrogr01,C,28,PHI,1,0,10,4,5,0.8,0,0,,4,5,0.8,0.8,1,1,1.0,1,1,2,2,1,0,0,1,9
382,Kyle O'Quinn\oquinky01,C,28,IND,44,2,360,67,131,0.511,1,12,0.083,66,119,0.555,0.515,15,19,0.789,28,88,116,54,9,23,30,66,150
402,Mason Plumlee\plumlma01,C,28,DEN,80,17,1682,257,433,0.594,2,10,0.2,255,423,0.603,0.596,109,193,0.565,163,347,510,233,64,75,125,248,625
490,Nikola Vucevic\vucevni01,C,28,ORL,80,80,2510,701,1354,0.518,84,231,0.364,617,1123,0.549,0.549,179,227,0.789,224,736,960,307,81,89,159,157,1665
128,Ed Davis\davised01,C,29,BRK,80,1,1431,183,297,0.616,0,2,0.0,183,295,0.62,0.616,100,162,0.617,213,471,684,61,35,33,64,226,466
130,Dewayne Dedmon\dedmode01,C,29,ATL,64,52,1609,259,526,0.492,83,217,0.382,176,309,0.57,0.571,92,113,0.814,105,375,480,90,69,71,84,214,693
139,Gorgui Dieng\dienggo01,C,29,MIN,74,0,968,176,348,0.506,16,51,0.314,160,297,0.539,0.529,83,100,0.83,75,218,293,65,44,40,50,127,451
162,Kenneth Faried\farieke01,C,29,TOT,37,13,728,156,265,0.589,8,25,0.32,148,240,0.617,0.604,64,99,0.646,97,153,250,20,17,23,33,82,384
162,Kenneth Faried\farieke01,C,29,BRK,12,0,118,25,42,0.595,1,5,0.2,24,37,0.649,0.607,10,16,0.625,15,29,44,2,2,4,6,8,61
162,Kenneth Faried\farieke01,C,29,HOU,25,13,610,131,223,0.587,7,20,0.35,124,203,0.611,0.603,54,83,0.651,82,124,206,18,15,19,27,74,323
242,Serge Ibaka\ibakase01,C,29,TOR,74,51,2010,464,877,0.529,49,169,0.29,415,708,0.586,0.557,135,177,0.763,156,445,601,99,29,103,114,211,1112
288,Kosta Koufos\koufoko01,C,29,SAC,42,1,502,73,153,0.477,0,0,,73,153,0.477,0.477,10,24,0.417,52,125,177,36,15,18,27,68,156
507,Hassan Whiteside\whiteha01,C,29,MIA,71,53,1661,381,672,0.567,2,16,0.125,379,656,0.578,0.568,108,241,0.448,256,552,808,56,44,132,96,191,872
526,Tyler Zeller\zellety01,C,29,TOT,4,0,55,9,17,0.529,0,1,0.0,9,16,0.563,0.529,7,8,0.875,7,7,14,1,1,1,0,12,25
526,Tyler Zeller\zellety01,C,29,ATL,2,0,11,0,2,0.0,0,1,0.0,0,1,0.0,0.0,0,0,,2,4,6,1,0,0,0,4,0
526,Tyler Zeller\zellety01,C,29,MEM,2,0,44,9,15,0.6,0,0,,9,15,0.6,0.6,7,8,0.875,5,3,8,0,1,1,0,8,25
275,DeAndre Jordan\jordade01,C,30,TOT,69,69,2047,286,446,0.641,0,0,,286,446,0.641,0.641,186,264,0.705,225,677,902,156,42,73,153,167,758
275,DeAndre Jordan\jordade01,C,30,DAL,50,50,1554,208,323,0.644,0,0,,208,323,0.644,0.644,135,198,0.682,161,525,686,99,33,53,111,125,551
275,DeAndre Jordan\jordade01,C,30,NYK,19,19,493,78,123,0.634,0,0,,78,123,0.634,0.634,51,66,0.773,64,152,216,57,9,20,42,42,207
309,Brook Lopez\lopezbr01,C,30,MIL,81,81,2322,355,786,0.452,187,512,0.365,168,274,0.613,0.571,112,133,0.842,33,363,396,98,51,179,82,189,1009
310,Robin Lopez\lopezro01,C,30,CHI,72,34,1549,293,513,0.571,6,27,0.222,287,486,0.591,0.577,88,121,0.727,136,143,279,87,11,76,95,122,680
324,Boban Marjanovic\marjabo01,C,30,TOT,56,11,637,146,238,0.613,2,7,0.286,144,231,0.623,0.618,98,131,0.748,85,167,252,46,14,25,57,89,392
324,Boban Marjanovic\marjabo01,C,30,LAC,36,9,376,85,140,0.607,0,2,0.0,85,138,0.616,0.607,72,95,0.758,55,97,152,22,11,17,37,57,242
324,Boban Marjanovic\marjabo01,C,30,PHI,20,2,261,61,98,0.622,2,5,0.4,59,93,0.634,0.633,26,36,0.722,30,70,100,24,3,8,20,32,150
403,Miles Plumlee\plumlmi01,C,30,ATL,18,0,173,32,48,0.667,0,0,,32,48,0.667,0.667,16,30,0.533,16,23,39,17,6,4,10,14,80
262,Amir Johnson\johnsam01,C,31,PHI,49,6,487,73,143,0.51,11,37,0.297,62,106,0.585,0.549,27,36,0.75,41,90,131,57,15,11,45,94,184
335,JaVale McGee\mcgeeja01,C,31,LAL,74,61,1651,395,635,0.622,1,12,0.083,394,623,0.632,0.623,95,148,0.642,194,368,562,51,47,147,105,202,886
484,Ekpe Udoh\udohek01,C,31,UTA,49,0,290,45,65,0.692,0,0,,45,65,0.692,0.692,15,24,0.625,24,52,76,23,10,27,11,34,105
38,Aron Baynes\baynear01,C,32,BOS,51,18,821,105,223,0.471,21,61,0.344,84,162,0.519,0.518,53,62,0.855,88,152,240,57,12,34,40,125,284
236,Al Horford\horfoal01,C,32,BOS,68,68,1973,387,723,0.535,73,203,0.36,314,520,0.604,0.586,78,95,0.821,120,338,458,283,59,86,102,126,925
322,Ian Mahinmi\mahinia01,C,32,WAS,33,6,473,43,91,0.473,1,13,0.077,42,78,0.538,0.478,41,60,0.683,44,72,116,24,24,15,20,79,128
341,Salah Mejri\mejrisa01,C,32,DAL,35,4,384,54,107,0.505,11,30,0.367,43,77,0.558,0.556,20,32,0.625,36,88,124,34,9,24,21,55,139
454,Jason Smith\smithja02,C,32,WAS,12,1,130,15,37,0.405,4,10,0.4,11,27,0.407,0.459,10,12,0.833,11,26,37,12,1,5,7,21,44
454,Jason Smith\smithja02,C,32,NOP,2,0,20,2,9,0.222,2,7,0.286,0,2,0.0,0.333,2,2,1.0,2,2,4,1,0,0,1,3,8
8,LaMarcus Aldridge\aldrila01,C,33,SAS,80,80,2651,669,1298,0.515,10,41,0.244,659,1257,0.524,0.519,345,407,0.848,246,482,728,193,42,106,142,178,1693
238,Dwight Howard\howardw01,C,33,WAS,9,9,230,43,69,0.623,0,0,,43,69,0.623,0.623,29,48,0.604,24,59,83,4,7,4,16,34,115
374,Joakim Noah\noahjo01,C,33,MEM,42,1,693,110,213,0.516,0,1,0.0,110,212,0.519,0.516,78,109,0.716,58,180,238,89,20,31,50,96,298
58,Andrew Bogut\bogutan01,C,34,GSW,10,4,117,18,35,0.514,0,0,,18,35,0.514,0.514,3,3,1.0,11,38,49,10,2,6,3,21,39
180,Marc Gasol\gasolma01,C,34,TOT,78,71,2412,387,865,0.447,97,270,0.359,290,595,0.487,0.503,191,249,0.767,78,543,621,348,83,86,153,216,1062
180,Marc Gasol\gasolma01,C,34,MEM,53,53,1788,303,683,0.444,76,221,0.344,227,462,0.491,0.499,152,201,0.756,56,399,455,248,60,63,119,147,834
180,Marc Gasol\gasolma01,C,34,TOR,25,18,624,84,182,0.462,21,49,0.429,63,133,0.474,0.519,39,48,0.813,22,144,166,100,23,23,34,69,228
191,Marcin Gortat\gortama01,C,34,LAC,47,43,751,99,186,0.532,0,0,,99,186,0.532,0.532,35,48,0.729,67,194,261,65,6,24,50,92,233
391,Zaza Pachulia\pachuza01,C,34,DET,66,3,856,82,185,0.443,0,4,0.0,82,181,0.453,0.443,94,120,0.783,93,161,254,88,30,17,55,147,258
175,Channing Frye\fryech01,C,35,CLE,35,6,334,40,111,0.36,30,76,0.395,10,35,0.286,0.495,9,12,0.75,4,48,52,20,6,5,12,43,119
100,Tyson Chandler\chandty01,C,36,TOT,55,6,875,61,99,0.616,0,1,0.0,61,98,0.622,0.616,51,87,0.586,92,215,307,37,21,23,42,110,173
100,Tyson Chandler\chandty01,C,36,PHO,7,0,89,8,12,0.667,0,0,,8,12,0.667,0.667,10,18,0.556,7,32,39,6,2,1,7,21,26
100,Tyson Chandler\chandty01,C,36,LAL,48,6,786,53,87,0.609,0,1,0.0,53,86,0.616,0.609,41,69,0.594,85,183,268,31,19,22,35,89,147
226,Nene Hilario\hilarne01,C,36,HOU,41,2,534,60,114,0.526,0,3,0.0,60,111,0.541,0.526,31,47,0.66,33,88,121,25,18,15,10,85,151
181,Pau Gasol\gasolpa01,C,38,TOT,30,6,360,42,94,0.447,6,13,0.462,36,81,0.444,0.479,28,40,0.7,22,115,137,52,5,15,16,29,118
181,Pau Gasol\gasolpa01,C,38,SAS,27,6,330,41,88,0.466,5,10,0.5,36,78,0.462,0.494,27,38,0.711,22,105,127,50,5,14,14,28,114
181,Pau Gasol\gasolpa01,C,38,MIL,3,0,30,1,6,0.167,1,3,0.333,0,3,0.0,0.25,1,2,0.5,0,10,10,2,0,1,2,1,4
217,Udonis Haslem\hasleud01,C,38,MIA,8,0,35,3,9,0.333,0,4,0.0,3,5,0.6,0.333,0,0,,1,11,12,0,0,0,2,4,6
376,Dirk Nowitzki\nowitdi01,PF,40,DAL,49,18,731,116,324,0.358,57,185,0.308,59,139,0.424,0.446,34,45,0.756,4,136,140,31,8,17,16,71,323
27,Marvin Bagley\baglema01,PF,19,SAC,61,4,1537,348,691,0.504,28,91,0.308,320,600,0.533,0.524,179,260,0.688,162,300,462,62,32,59,97,118,903
253,Jaren Jackson\jacksja02,PF,19,MEM,58,56,1515,298,589,0.506,51,142,0.359,247,447,0.553,0.549,151,197,0.766,73,199,272,64,52,82,98,220,798
284,Kevin Knox\knoxke01,PF,19,NYK,73,55,2095,330,886,0.372,121,350,0.346,209,536,0.39,0.441,156,218,0.716,58,260,318,79,43,24,110,172,937
487,Jarred Vanderbilt\vandeja01,PF,19,DEN,16,0,66,8,18,0.444,0,1,0.0,8,17,0.471,0.444,4,8,0.5,7,16,23,3,5,1,8,8,20
185,Harry Giles\gilesha01,PF,20,SAC,58,0,820,175,348,0.503,0,6,0.0,175,342,0.512,0.503,58,91,0.637,66,156,222,85,31,22,73,150,408
216,Isaiah Hartenstein\harteis01,PF,20,HOU,28,0,221,20,41,0.488,2,6,0.333,18,35,0.514,0.512,11,14,0.786,21,26,47,15,7,12,13,56,53
19,Kostas Antetokounmpo\antetko01,PF,21,DAL,2,0,11,0,3,0.0,0,0,,0,3,0.0,0.0,2,4,0.5,0,1,1,0,2,0,1,0,2
46,Dragan Bender\bendedr01,PF,21,PHO,45,26,790,84,188,0.447,21,97,0.216,63,91,0.692,0.503,29,50,0.58,32,140,172,50,17,21,35,86,218
104,Marquese Chriss\chrisma01,PF,21,TOT,42,2,484,63,169,0.373,16,69,0.232,47,100,0.47,0.42,32,45,0.711,37,98,135,21,16,11,36,81,174
104,Marquese Chriss\chrisma01,PF,21,HOU,16,0,104,11,34,0.324,1,15,0.067,10,19,0.526,0.338,6,7,0.857,7,21,28,6,2,4,12,17,29
104,Marquese Chriss\chrisma01,PF,21,CLE,26,2,380,52,135,0.385,15,54,0.278,37,81,0.457,0.441,26,38,0.684,30,77,107,15,14,7,24,64,145
108,John Collins\collijo01,PF,21,ATL,60,58,1793,457,816,0.56,54,156,0.346,403,660,0.611,0.593,200,262,0.763,210,360,570,115,22,38,117,197,1168
157,Drew Eubanks\eubandr01,PF,21,SAS,22,0,111,15,25,0.6,0,0,,15,25,0.6,0.6,11,13,0.846,6,28,34,7,2,5,8,10,41
249,Jonathan Isaac\isaacjo01,PF,21,ORL,75,64,1996,262,611,0.429,86,266,0.323,176,345,0.51,0.499,110,135,0.815,99,312,411,80,59,98,75,143,720
295,T.J. Leaf\leaftj01,PF,21,IND,57,0,487,87,164,0.53,8,29,0.276,79,135,0.585,0.555,15,26,0.577,39,77,116,22,7,17,12,33,197
323,Thon Maker\makerth01,PF,21,DET,27,4,535,50,131,0.382,23,74,0.311,27,57,0.474,0.469,34,45,0.756,23,79,102,26,11,33,23,49,157
325,Lauri Markkanen\markkla01,PF,21,CHI,52,51,1682,342,795,0.43,120,332,0.361,222,463,0.479,0.506,170,195,0.872,74,396,470,75,37,33,85,122,974
343,Chimezie Metu\metuch01,PF,21,SAS,29,0,145,19,58,0.328,0,2,0.0,19,56,0.339,0.328,13,17,0.765,9,27,36,13,6,2,15,14,51
412,Ivan Rabb\rabbiv01,PF,21,MEM,47,12,663,109,196,0.556,3,13,0.231,106,183,0.579,0.564,48,67,0.716,66,122,188,46,16,14,31,82,269
457,Ray Spalding\spaldra01,PF,21,TOT,13,2,129,24,40,0.6,0,2,0.0,24,38,0.632,0.6,4,10,0.4,14,27,41,3,7,6,8,21,52
457,Ray Spalding\spaldra01,PF,21,DAL,1,0,1,0,0,,0,0,,0,0,,,0,0,,0,0,0,0,0,0,0,0,0
457,Ray Spalding\spaldra01,PF,21,PHO,12,2,128,24,40,0.6,0,2,0.0,24,38,0.632,0.6,4,10,0.4,14,27,41,3,7,6,8,21,52
458,Omari Spellman\spellom01,PF,21,ATL,46,11,805,98,244,0.402,44,128,0.344,54,116,0.466,0.492,32,45,0.711,72,122,194,47,26,25,31,67,272
463,Caleb Swanigan\swanica01,PF,21,TOT,20,0,160,16,48,0.333,1,6,0.167,15,42,0.357,0.344,6,9,0.667,14,43,57,8,4,0,18,26,39
463,Caleb Swanigan\swanica01,PF,21,POR,18,0,145,14,44,0.318,1,5,0.2,13,39,0.333,0.33,6,7,0.857,13,39,52,7,4,0,16,22,35
463,Caleb Swanigan\swanica01,PF,21,SAC,2,0,15,2,4,0.5,0,1,0.0,2,3,0.667,0.5,0,2,0.0,1,4,5,1,0,0,2,4,4
136,Marcus Derrickson\derrima01,PF,22,GSW,9,0,54,10,24,0.417,5,14,0.357,5,10,0.5,0.521,3,4,0.75,5,3,8,1,0,1,3,9,28
137,Cheick Diallo\diallch01,PF,22,NOP,63,1,871,163,264,0.617,0,3,0.0,163,261,0.625,0.617,50,67,0.746,75,251,326,28,29,33,49,110,376
153,Henry Ellenson\ellenhe01,PF,22,TOT,17,0,224,33,80,0.413,14,32,0.438,19,48,0.396,0.5,17,21,0.81,5,52,57,16,7,0,9,22,97
153,Henry Ellenson\ellenhe01,PF,22,DET,2,0,25,4,10,0.4,2,4,0.5,2,6,0.333,0.5,2,2,1.0,0,9,9,1,0,0,0,2,12
153,Henry Ellenson\ellenhe01,PF,22,NYK,15,0,199,29,70,0.414,12,28,0.429,17,42,0.405,0.5,15,19,0.789,5,43,48,15,7,0,9,20,85
261,Alize Johnson\johnsal02,PF,22,IND,13,0,39,2,11,0.182,1,2,0.5,1,9,0.111,0.227,1,4,0.25,1,7,8,0,0,1,0,5,6
291,Skal Labissiere\labissk01,PF,22,TOT,21,0,136,14,32,0.438,4,11,0.364,10,21,0.476,0.5,6,13,0.462,5,23,28,10,3,5,9,24,38
291,Skal Labissiere\labissk01,PF,22,SAC,13,0,113,13,30,0.433,4,11,0.364,9,19,0.474,0.5,6,11,0.545,4,20,24,6,2,3,7,21,36
291,Skal Labissiere\labissk01,PF,22,POR,8,0,23,1,2,0.5,0,0,,1,2,0.5,0.5,0,2,0.0,1,3,4,4,1,2,2,3,2
316,Tyler Lydon\lydonty01,PF,22,DEN,25,0,94,9,18,0.5,4,10,0.4,5,8,0.625,0.611,1,3,0.333,7,11,18,6,2,0,4,10,23
469,Emanuel Terry\terryem01,PF,22,TOT,3,0,23,4,7,0.571,0,0,,4,7,0.571,0.571,2,4,0.5,3,4,7,2,3,0,2,4,10
469,Emanuel Terry\terryem01,PF,22,PHO,2,0,20,4,6,0.667,0,0,,4,6,0.667,0.667,1,2,0.5,2,4,6,1,3,0,2,4,9
469,Emanuel Terry\terryem01,PF,22,MIA,1,0,3,0,1,0.0,0,0,,0,1,0.0,0.0,1,2,0.5,1,0,1,1,0,0,0,0,1
517,D.J. Wilson\wilsodj01,PF,22,MIL,47,2,835,96,231,0.416,44,120,0.367,52,111,0.468,0.511,26,47,0.553,41,164,205,48,17,20,31,84,262
59,Jonah Bolden\boldejo01,PF,23,PHI,43,9,626,80,159,0.503,34,93,0.366,46,66,0.697,0.61,13,27,0.481,47,118,165,39,17,39,36,98,207
189,Aaron Gordon\gordoaa01,PF,23,ORL,77,77,2600,459,1028,0.446,120,344,0.349,339,684,0.496,0.505,181,249,0.727,127,440,567,286,57,56,160,171,1219
220,Juan Hernangomez\hernaju01,PF,23,DEN,69,25,1348,138,314,0.439,66,181,0.365,72,133,0.541,0.545,66,86,0.767,64,199,263,53,27,24,37,92,408
286,Luke Kornet\kornelu01,PF,23,NYK,44,16,717,100,260,0.385,66,178,0.371,34,82,0.415,0.512,38,46,0.826,24,96,120,48,27,36,25,39,304
290,Kyle Kuzma\kuzmaky01,PF,23,LAL,70,68,2314,496,1087,0.456,128,422,0.303,368,665,0.553,0.515,188,250,0.752,60,322,382,178,41,26,133,170,1308
317,Trey Lyles\lylestr01,PF,23,DEN,64,2,1120,207,495,0.418,51,200,0.255,156,295,0.529,0.47,81,116,0.698,44,202,246,87,30,23,68,93,546
363,Johnathan Motley\motlejo01,PF,23,LAC,22,0,156,39,73,0.534,0,3,0.0,39,70,0.557,0.534,24,40,0.6,18,33,51,11,5,3,16,27,102
392,Jabari Parker\parkeja01,PF,23,TOT,64,17,1724,369,749,0.493,61,195,0.313,308,554,0.556,0.533,131,184,0.712,79,342,421,152,46,30,151,145,930
392,Jabari Parker\parkeja01,PF,23,CHI,39,17,1042,220,464,0.474,37,114,0.325,183,350,0.523,0.514,79,108,0.731,41,200,241,84,23,14,84,87,556
392,Jabari Parker\parkeja01,PF,23,WAS,25,0,682,149,285,0.523,24,81,0.296,125,204,0.613,0.565,52,76,0.684,38,142,180,68,23,16,67,58,374
407,Bobby Portis\portibo01,PF,23,TOT,49,27,1276,275,619,0.444,74,188,0.394,201,431,0.466,0.504,75,95,0.789,108,287,395,68,34,20,72,144,699
407,Bobby Portis\portibo01,PF,23,CHI,22,6,531,122,271,0.45,27,72,0.375,95,199,0.477,0.5,39,50,0.78,46,115,161,29,11,8,29,61,310
407,Bobby Portis\portibo01,PF,23,WAS,27,21,745,153,348,0.44,47,116,0.405,106,232,0.457,0.507,36,45,0.8,62,172,234,39,23,12,43,83,389
411,Zhou Qi\qizh01,PF,23,HOU,1,0,1,1,1,1.0,0,0,,1,1,1.0,1.0,0,0,,0,0,0,0,0,0,0,0,2
489,Noah Vonleh\vonleno01,PF,23,NYK,68,57,1722,207,440,0.47,46,137,0.336,161,303,0.531,0.523,111,156,0.712,113,415,528,129,46,51,88,174,571
519,Christian Wood\woodch01,PF,23,TOT,20,1,217,51,96,0.531,7,19,0.368,44,77,0.571,0.568,37,51,0.725,15,56,71,8,7,10,14,14,146
519,Christian Wood\woodch01,PF,23,MIL,13,0,62,12,25,0.48,3,5,0.6,9,20,0.45,0.54,10,15,0.667,4,16,20,2,0,0,3,3,37
519,Christian Wood\woodch01,PF,23,NOP,7,1,155,39,71,0.549,4,14,0.286,35,57,0.614,0.577,27,36,0.75,11,40,51,6,7,10,11,11,109
521,Guerschon Yabusele\yabusgu01,PF,23,BOS,40,0,226,30,67,0.448,6,23,0.261,24,44,0.545,0.493,15,20,0.75,22,26,48,14,8,7,15,31,81
18,Giannis Antetokounmpo\antetgi01,PF,24,MIL,72,72,2358,721,1247,0.578,52,203,0.256,669,1044,0.641,0.599,500,686,0.729,159,739,898,424,92,110,268,232,1994
99,Tyler Cavanaugh\cavanty01,PF,24,UTA,9,0,22,3,8,0.375,1,5,0.2,2,3,0.667,0.438,2,2,1.0,1,4,5,0,0,0,1,0,9
105,Gary Clark\clarkga01,PF,24,HOU,51,2,641,50,151,0.331,41,138,0.297,9,13,0.692,0.467,7,7,1.0,24,92,116,18,20,26,7,47,148
131,Sam Dekker\dekkesa01,PF,24,TOT,46,5,757,118,245,0.482,18,57,0.316,100,188,0.532,0.518,28,46,0.609,50,91,141,45,38,7,24,45,282
131,Sam Dekker\dekkesa01,PF,24,CLE,9,5,169,22,48,0.458,5,13,0.385,17,35,0.486,0.51,8,10,0.8,9,24,33,9,11,0,5,13,57
131,Sam Dekker\dekkesa01,PF,24,WAS,37,0,588,96,197,0.487,13,44,0.295,83,153,0.542,0.52,20,36,0.556,41,67,108,36,27,7,19,32,225
194,Jerami Grant\grantje01,PF,24,OKC,78,75,2533,395,793,0.498,109,279,0.391,286,514,0.556,0.567,153,217,0.705,92,315,407,77,60,99,66,211,1052
223,Isaiah Hicks\hicksis01,PF,24,NYK,1,0,4,0,0,,0,0,,0,0,,,1,2,0.5,0,0,0,1,0,0,0,0,1
326,Jarell Martin\martija01,PF,24,ORL,41,1,308,42,100,0.42,20,54,0.37,22,46,0.478,0.52,9,11,0.818,11,59,70,17,3,8,11,49,113
383,Semi Ojeleye\ojelese01,PF,24,BOS,55,2,556,60,141,0.426,26,82,0.317,34,59,0.576,0.518,23,35,0.657,22,60,82,20,9,4,19,42,169
414,Julius Randle\randlju01,PF,24,NOP,73,49,2232,571,1089,0.524,67,195,0.344,504,894,0.564,0.555,356,487,0.731,162,472,634,229,52,45,208,246,1565
422,Duncan Robinson\robindu01,PF,24,MIA,13,1,114,11,32,0.344,7,26,0.269,4,6,0.667,0.453,2,3,0.667,0,13,13,2,3,0,2,8,31
435,Dario Saric\saricda01,PF,24,TOT,79,39,1969,295,671,0.44,116,312,0.372,179,359,0.499,0.526,126,144,0.875,123,318,441,124,45,9,95,177,832
435,Dario Saric\saricda01,PF,24,PHI,13,13,396,48,132,0.364,21,70,0.3,27,62,0.435,0.443,27,30,0.9,21,65,86,26,4,3,25,39,144
435,Dario Saric\saricda01,PF,24,MIN,66,26,1573,247,539,0.458,95,242,0.393,152,297,0.512,0.546,99,114,0.868,102,253,355,98,41,6,70,138,688
444,Pascal Siakam\siakapa01,PF,24,TOR,79,78,2530,515,939,0.548,78,212,0.368,437,727,0.601,0.59,236,300,0.787,124,421,545,246,72,52,152,237,1344
258,Amile Jefferson\jeffeam01,PF,25,ORL,11,0,44,7,12,0.583,0,0,,7,12,0.583,0.583,7,8,0.875,4,10,14,2,2,3,0,5,21
280,Michael Kidd-Gilchrist\kiddgmi01,PF,25,CHO,63,3,1178,158,332,0.476,16,47,0.34,142,285,0.498,0.5,95,123,0.772,88,158,246,61,32,39,43,156,427
373,Georges Niang\niangge01,PF,25,UTA,57,0,455,74,155,0.477,40,97,0.412,34,58,0.586,0.606,16,20,0.8,9,70,79,30,10,4,19,52,204
410,Alex Poythress\poythal01,PF,25,ATL,21,1,305,40,81,0.494,9,23,0.391,31,58,0.534,0.549,18,29,0.621,29,47,76,17,4,10,13,47,107
33,Harrison Barnes\barneha02,PF,26,DAL,49,49,1584,290,717,0.404,121,311,0.389,169,406,0.416,0.489,165,198,0.833,36,171,207,62,33,11,68,79,866
48,Davis Bertans\bertada01,PF,26,SAS,75,12,1612,201,444,0.453,142,330,0.43,59,114,0.518,0.613,53,60,0.883,23,238,261,99,35,33,43,133,597
62,Chris Boucher\bouchch01,PF,26,TOR,27,0,139,27,66,0.409,11,34,0.324,16,32,0.5,0.492,13,15,0.867,15,28,43,0,6,22,5,29,78
212,Tobias Harris\harrito02,PF,26,TOT,81,81,2827,608,1238,0.491,156,387,0.403,452,851,0.531,0.554,266,307,0.866,67,569,636,227,51,37,151,184,1638
212,Tobias Harris\harrito02,PF,26,LAC,55,55,1903,424,855,0.496,112,258,0.434,312,597,0.523,0.561,192,219,0.877,37,395,432,150,40,24,109,123,1152
212,Tobias Harris\harrito02,PF,26,PHI,26,26,924,184,383,0.48,44,129,0.341,140,254,0.551,0.538,74,88,0.841,30,174,204,77,11,13,42,61,486
506,Okaro White\whiteok01,PF,26,WAS,3,0,6,0,2,0.0,0,2,0.0,0,0,,0.0,0,0,,1,1,2,0,0,0,0,0,0
509,Alan Williams\willial03,PF,26,BRK,4,0,22,6,10,0.6,0,1,0.0,6,9,0.667,0.6,2,4,0.5,4,13,17,3,1,0,1,2,14
273,Terrence Jones\joneste01,PF,27,HOU,2,0,5,1,4,0.25,0,2,0.0,1,2,0.5,0.25,0,1,0.0,0,4,4,0,0,0,1,1,2
282,Maxi Kleber\klebima01,PF,27,DAL,70,18,1482,174,385,0.452,76,217,0.35,98,168,0.583,0.551,57,72,0.792,89,230,319,69,36,77,52,140,481
351,Nikola Mirotic\mirotni01,PF,27,TOT,46,25,1245,238,542,0.439,116,318,0.365,122,224,0.545,0.546,105,124,0.847,60,279,339,55,31,34,48,107,697
351,Nikola Mirotic\mirotni01,PF,27,NOP,32,22,925,182,407,0.447,85,231,0.368,97,176,0.551,0.552,85,101,0.842,46,218,264,35,21,25,37,86,534
351,Nikola Mirotic\mirotni01,PF,27,MIL,14,3,320,56,135,0.415,31,87,0.356,25,48,0.521,0.53,20,23,0.87,14,61,75,20,10,9,11,21,163
357,Eric Moreland\moreler01,PF,27,TOT,4,0,36,3,6,0.5,1,1,1.0,2,5,0.4,0.583,0,0,,3,13,16,4,0,0,3,9,7
357,Eric Moreland\moreler01,PF,27,PHO,1,0,5,0,0,,0,0,,0,0,,,0,0,,0,3,3,0,0,0,0,1,0
357,Eric Moreland\moreler01,PF,27,TOR,3,0,31,3,6,0.5,1,1,1.0,2,5,0.4,0.583,0,0,,3,10,13,4,0,0,3,8,7
367,Mike Muscala\muscami01,PF,27,TOT,63,9,1270,139,351,0.396,85,249,0.341,54,102,0.529,0.517,70,85,0.824,56,183,239,75,22,38,47,128,433
367,Mike Muscala\muscami01,PF,27,PHI,47,6,1041,109,278,0.392,68,199,0.342,41,79,0.519,0.514,63,77,0.818,51,149,200,62,18,27,43,112,349
367,Mike Muscala\muscami01,PF,27,LAL,16,3,229,30,73,0.411,17,50,0.34,13,23,0.565,0.527,7,8,0.875,5,34,39,13,4,11,4,16,84
388,Kelly Olynyk\olynyke01,PF,27,MIA,77,34,1769,254,552,0.46,111,315,0.352,143,237,0.603,0.561,151,184,0.821,71,296,367,138,52,34,110,181,770
2,Quincy Acy\acyqu01,PF,28,PHO,10,0,123,4,18,0.222,2,15,0.133,2,3,0.667,0.278,7,10,0.7,3,22,25,8,1,4,4,24,17
13,Al-Farouq Aminu\aminual01,PF,28,POR,80,80,2273,257,589,0.436,96,277,0.347,161,312,0.516,0.518,150,173,0.867,112,493,605,104,67,33,72,143,760
198,Draymond Green\greendr01,PF,28,GSW,65,65,2047,188,420,0.448,47,165,0.285,141,255,0.553,0.504,63,91,0.692,60,415,475,452,95,70,166,195,486
200,JaMychal Green\greenja01,PF,28,TOT,64,6,1345,226,467,0.484,68,171,0.398,158,296,0.534,0.557,78,98,0.796,104,303,407,49,45,33,86,188,598
200,JaMychal Green\greenja01,PF,28,MEM,41,4,900,151,312,0.484,38,96,0.396,113,216,0.523,0.545,63,80,0.788,72,180,252,36,33,26,64,123,403
200,JaMychal Green\greenja01,PF,28,LAC,23,2,445,75,155,0.484,30,75,0.4,45,80,0.563,0.581,15,18,0.833,32,123,155,13,12,7,22,65,195
218,Gordon Hayward\haywago01,PF,28,BOS,72,18,1863,296,635,0.466,77,231,0.333,219,404,0.542,0.527,156,187,0.834,51,271,322,244,62,23,105,104,825
362,Donatas Motiejunas\motiedo01,PF,28,SAS,2,0,10,2,5,0.4,0,0,,2,5,0.4,0.4,0,2,0.0,1,1,2,1,0,1,1,5,4
202,Blake Griffin\griffbl01,PF,29,DET,74,74,2604,617,1336,0.462,188,520,0.362,429,816,0.526,0.532,414,550,0.753,100,463,563,401,51,27,253,197,1836
302,Jon Leuer\leuerjo01,PF,29,DET,40,1,398,65,112,0.58,1,11,0.091,64,101,0.634,0.585,23,31,0.742,27,69,96,14,12,4,23,60,154
359,Marcus Morris\morrima03,PF,29,BOS,75,53,2091,377,844,0.447,146,389,0.375,231,455,0.508,0.533,146,173,0.844,76,382,458,109,43,25,92,181,1046
360,Markieff Morris\morrima02,PF,29,TOT,56,16,1233,197,472,0.417,66,199,0.332,131,273,0.48,0.487,70,90,0.778,56,192,248,75,36,22,54,170,530
360,Markieff Morris\morrima02,PF,29,WAS,34,15,883,143,328,0.436,48,144,0.333,95,184,0.516,0.509,57,73,0.781,41,133,174,60,25,20,47,117,391
360,Markieff Morris\morrima02,PF,29,OKC,22,1,350,54,144,0.375,18,55,0.327,36,89,0.404,0.438,13,17,0.765,15,59,74,15,11,2,7,53,139
395,Patrick Patterson\pattepa01,PF,29,OKC,63,5,861,82,219,0.374,46,137,0.336,36,82,0.439,0.479,19,30,0.633,42,105,147,31,16,13,22,46,229
16,Ryan Anderson\anderry01,PF,30,TOT,24,8,321,21,69,0.304,9,40,0.225,12,29,0.414,0.37,12,16,0.75,18,36,54,19,4,1,14,25,63
16,Ryan Anderson\anderry01,PF,30,PHO,15,8,278,19,60,0.317,7,34,0.206,12,26,0.462,0.375,11,14,0.786,14,31,45,17,3,1,12,23,56
16,Ryan Anderson\anderry01,PF,30,MIA,9,0,43,2,9,0.222,2,6,0.333,0,3,0.0,0.333,1,2,0.5,4,5,9,2,1,0,2,2,7
42,Michael Beasley\beaslmi01,PF,30,LAL,26,2,277,75,153,0.49,3,17,0.176,72,136,0.529,0.5,28,39,0.718,13,47,60,25,9,10,27,42,181
52,Nemanja Bjelica\bjeline01,PF,30,SAC,76,69,1776,281,589,0.477,101,254,0.398,180,335,0.537,0.563,68,90,0.756,125,319,444,146,54,56,82,196,731
150,Kevin Durant\duranke01,PF,30,GSW,77,77,2683,714,1373,0.52,137,386,0.355,577,987,0.585,0.57,441,499,0.884,33,464,497,451,57,84,225,154,2006
311,Kevin Love\loveke01,PF,30,CLE,22,21,598,109,283,0.385,53,147,0.361,56,136,0.412,0.479,103,114,0.904,33,206,239,48,6,5,42,54,374
438,Mike Scott\scottmi01,PF,30,TOT,78,2,1374,165,414,0.399,100,251,0.398,65,163,0.399,0.519,22,33,0.667,43,226,269,65,26,12,44,155,452
438,Mike Scott\scottmi01,PF,30,LAC,52,0,748,92,230,0.4,52,133,0.391,40,97,0.412,0.513,12,18,0.667,24,150,174,44,17,8,27,88,248
438,Mike Scott\scottmi01,PF,30,PHI,26,2,626,73,184,0.397,48,118,0.407,25,66,0.379,0.527,10,15,0.667,19,76,95,21,9,4,17,67,204
473,Lance Thomas\thomala01,PF,30,NYK,46,17,783,78,197,0.396,22,79,0.278,56,118,0.475,0.452,27,36,0.75,21,96,117,27,17,7,24,83,205
523,Thaddeus Young\youngth01,PF,30,IND,81,81,2489,443,841,0.527,51,146,0.349,392,695,0.564,0.557,87,135,0.644,192,331,523,204,123,36,123,194,1024
101,Wilson Chandler\chandwi01,PF,31,PHI,36,32,951,91,207,0.44,46,118,0.39,45,89,0.506,0.551,13,18,0.722,44,124,168,72,22,18,39,94,241
122,Dante Cunningham\cunnida01,PF,31,SAS,64,21,928,75,158,0.475,30,65,0.462,45,93,0.484,0.57,14,18,0.778,48,140,188,50,27,13,22,71,194
244,Ersan Ilyasova\ilyaser01,PF,31,MIL,66,6,1208,166,376,0.441,58,157,0.369,108,219,0.493,0.519,59,71,0.831,94,200,294,52,32,20,46,169,449
245,Joe Ingles\inglejo01,PF,31,UTA,80,80,2519,354,791,0.448,186,475,0.392,168,316,0.532,0.565,85,121,0.702,34,288,322,454,95,20,189,175,979
260,Jonas Jerebko\jerebjo01,PF,31,GSW,71,6,1186,157,342,0.459,68,183,0.372,89,159,0.56,0.558,64,80,0.8,71,212,283,90,27,17,42,135,446
264,James Johnson\johnsja01,PF,31,MIA,53,33,1133,163,377,0.432,50,148,0.338,113,229,0.493,0.499,50,70,0.714,22,149,171,129,34,27,69,110,426
90,DeMarre Carroll\carrode01,PF,32,BRK,67,8,1703,227,575,0.395,106,310,0.342,121,265,0.457,0.487,184,242,0.76,68,281,349,85,31,10,73,114,744
182,Rudy Gay\gayru01,PF,32,SAS,68,51,1814,374,736,0.508,74,182,0.407,300,554,0.542,0.558,117,143,0.818,63,397,460,179,54,34,112,159,939
201,Jeff Green\greenje02,PF,32,WAS,76,44,2073,324,674,0.481,110,312,0.353,214,362,0.591,0.562,182,204,0.892,57,247,304,134,43,38,99,160,940
329,Luc Mbah a Moute\mbahalu01,PF,32,LAC,4,0,61,8,18,0.444,2,6,0.333,6,12,0.5,0.5,2,5,0.4,2,5,7,2,1,1,2,8,20
454,Jason Smith\smithja02,PF,32,MIL,6,0,40,4,13,0.308,3,9,0.333,1,4,0.25,0.423,2,2,1.0,3,8,11,1,2,2,5,6,13
514,Marvin Williams\willima02,PF,32,CHO,75,75,2133,275,652,0.422,140,382,0.366,135,270,0.5,0.529,66,86,0.767,76,331,407,92,71,61,47,156,756
148,Jared Dudley\dudleja01,PF,33,BRK,59,25,1220,101,239,0.423,53,151,0.351,48,88,0.545,0.533,32,46,0.696,34,121,155,83,36,16,43,131,287
184,Taj Gibson\gibsota01,PF,33,MIN,70,57,1686,304,537,0.566,11,34,0.324,293,503,0.583,0.576,134,177,0.757,172,286,458,84,53,39,73,186,753
349,Paul Millsap\millspa01,PF,33,DEN,68,63,1841,318,651,0.488,56,154,0.364,262,497,0.527,0.531,177,243,0.728,151,342,493,137,83,53,92,178,869
477,Anthony Tolliver\tollian01,PF,33,MIN,63,0,1036,96,249,0.386,78,206,0.379,18,43,0.419,0.542,47,60,0.783,15,156,171,42,15,18,35,87,317
481,P.J. Tucker\tuckepj01,PF,33,HOU,81,81,2772,206,519,0.397,146,384,0.38,60,135,0.444,0.538,39,57,0.684,118,355,473,96,131,36,62,248,597
20,Carmelo Anthony\anthoca01,PF,34,HOU,10,2,294,49,121,0.405,21,64,0.328,28,57,0.491,0.492,15,22,0.682,9,45,54,5,4,7,8,32,134
287,Kyle Korver\korveky01,PF,37,CLE,16,0,251,35,76,0.461,25,54,0.463,10,22,0.455,0.625,13,16,0.813,0,29,29,17,3,2,17,22,108
60,Isaac Bonga\bongais01,PG,19,LAL,21,0,111,5,32,0.156,0,8,0.0,5,24,0.208,0.156,9,15,0.6,8,16,24,15,9,3,6,9,19
151,Trevon Duval\duvaltr01,PG,20,MIL,3,0,6,2,3,0.667,1,1,1.0,1,2,0.5,0.833,0,0,,0,1,1,2,0,0,0,0,5
186,Shai Gilgeous-Alexander\gilgesh01,PG,20,LAC,81,72,2150,338,710,0.476,51,139,0.367,287,571,0.503,0.512,154,193,0.798,57,173,230,267,94,45,140,171,881
252,Frank Jackson\jacksfr01,PG,20,NOP,61,16,1169,194,447,0.434,53,169,0.314,141,278,0.507,0.493,54,73,0.74,25,109,134,69,25,2,48,92,495
342,De'Anthony Melton\meltode01,PG,20,PHO,49,31,965,98,252,0.389,29,95,0.305,69,157,0.439,0.446,19,25,0.76,25,106,131,158,65,23,73,110,244
377,Frank Ntilikina\ntilila01,PG,20,NYK,43,16,904,95,282,0.337,33,115,0.287,62,167,0.371,0.395,23,30,0.767,12,75,87,121,30,14,56,104,246
441,Collin Sexton\sextoco01,PG,20,CLE,81,71,2567,511,1189,0.43,118,289,0.408,393,900,0.437,0.479,213,253,0.842,57,178,235,233,44,6,181,185,1353
524,Trae Young\youngtr01,PG,20,ATL,80,80,2470,519,1238,0.419,155,475,0.326,364,763,0.477,0.482,333,403,0.826,62,234,296,642,70,15,302,140,1526
30,Lonzo Ball\balllo01,PG,21,LAL,47,45,1423,185,456,0.406,75,228,0.329,110,228,0.482,0.488,20,48,0.417,54,197,251,255,69,19,103,114,465
171,De'Aaron Fox\foxde01,PG,21,SAC,80,80,2529,497,1092,0.455,85,231,0.368,412,861,0.479,0.494,303,417,0.727,43,260,303,581,133,45,226,203,1382
365,Jamal Murray\murraja01,PG,21,DEN,73,72,2382,498,1140,0.437,146,401,0.364,352,739,0.476,0.501,186,217,0.857,63,241,304,355,66,26,154,152,1328
385,Elie Okobo\okoboel01,PG,21,PHO,52,15,932,111,284,0.391,36,128,0.281,75,156,0.481,0.454,35,45,0.778,12,85,97,124,30,7,66,106,293
448,Kobi Simmons\simmoko01,PG,21,CLE,1,0,2,0,0,,0,0,,0,0,,,0,0,,0,0,0,0,0,0,0,0,0
451,Dennis Smith\smithde03,PG,21,TOT,52,49,1473,268,627,0.427,65,199,0.327,203,428,0.474,0.479,96,150,0.64,32,122,154,247,67,20,150,129,697
451,Dennis Smith\smithde03,PG,21,DAL,32,32,908,157,357,0.44,43,125,0.344,114,232,0.491,0.5,57,82,0.695,18,79,97,138,40,11,100,82,414
451,Dennis Smith\smithde03,PG,21,NYK,20,17,565,111,270,0.411,22,74,0.297,89,196,0.454,0.452,39,68,0.574,14,43,57,109,27,9,50,47,283
3,Jaylen Adams\adamsja01,PG,22,ATL,33,1,419,38,108,0.352,25,73,0.342,13,35,0.371,0.468,6,8,0.75,11,47,58,64,14,5,27,43,107
29,Wade Baldwin\baldwwa01,PG,22,POR,16,0,94,10,33,0.303,2,9,0.222,8,24,0.333,0.333,8,11,0.727,2,13,15,12,1,2,14,11,30
68,Isaiah Briscoe\briscis01,PG,22,ORL,39,0,559,55,138,0.399,11,34,0.324,44,104,0.423,0.438,15,26,0.577,5,69,74,87,11,2,31,66,136
78,Jalen Brunson\brunsja01,PG,22,DAL,71,37,1532,256,544,0.471,62,175,0.354,194,369,0.526,0.528,84,114,0.737,25,137,162,218,37,4,84,123,658
159,Jawun Evans\evansja01,PG,22,PHO,7,0,64,3,13,0.231,0,2,0.0,3,11,0.273,0.231,0,0,,1,11,12,10,3,0,6,8,6
229,Aaron Holiday\holidaa01,PG,22,IND,49,0,623,100,251,0.398,42,122,0.344,58,129,0.45,0.482,39,47,0.83,5,61,66,85,19,13,39,66,281
274,Tyus Jones\jonesty01,PG,22,MIN,66,21,1498,176,425,0.414,39,120,0.325,137,305,0.449,0.46,58,69,0.841,23,109,132,309,80,5,46,74,449
364,Emmanuel Mudiay\mudiaem01,PG,22,NYK,59,42,1607,330,740,0.446,69,210,0.329,261,530,0.492,0.493,144,186,0.774,33,163,196,228,43,19,140,103,873
431,D'Angelo Russell\russeda01,PG,22,BRK,80,80,2428,652,1504,0.434,227,624,0.364,425,880,0.483,0.509,160,205,0.78,51,257,308,558,99,20,252,141,1691
446,Ben Simmons\simmobe01,PG,22,PHI,78,78,2679,533,948,0.562,0,6,0.0,533,942,0.566,0.562,255,426,0.599,170,523,693,609,110,61,270,206,1321
91,Jevon Carter\carteje01,PG,23,MEM,37,3,532,43,163,0.264,23,86,0.267,20,77,0.26,0.334,22,28,0.786,12,47,59,65,25,11,32,52,131
98,Troy Caupain\caupatr01,PG,23,ORL,4,0,16,4,8,0.5,2,3,0.667,2,5,0.4,0.625,0,0,,1,2,3,4,1,0,0,0,10
102,Joe Chealey\chealjo01,PG,23,CHO,1,0,8,1,3,0.333,0,0,,1,3,0.333,0.333,0,0,,0,0,0,1,0,0,0,1,2
103,Chris Chiozza\chiozch01,PG,23,HOU,7,0,33,2,8,0.25,2,5,0.4,0,3,0.0,0.375,0,0,,1,3,4,4,1,1,1,2,6
161,Dante Exum\exumda01,PG,23,UTA,42,1,664,101,241,0.419,18,62,0.29,83,179,0.464,0.456,68,86,0.791,16,52,68,110,14,5,52,69,288
188,Brandon Goodwin\goodwbr01,PG,23,DEN,16,0,57,6,23,0.261,2,6,0.333,4,17,0.235,0.304,9,11,0.818,1,2,3,14,0,0,3,7,23
192,Devonte' Graham\grahade01,PG,23,CHO,44,3,638,70,204,0.343,32,113,0.283,38,91,0.418,0.422,33,44,0.75,9,48,57,114,22,2,28,46,205
361,Monte Morris\morrimo01,PG,23,DEN,80,6,1919,335,681,0.492,91,221,0.412,244,460,0.53,0.559,61,77,0.792,35,154,189,291,71,4,52,100,822
462,Edmond Sumner\sumneed01,PG,23,IND,22,2,180,17,50,0.34,4,20,0.2,13,30,0.433,0.38,6,13,0.462,7,13,20,9,10,5,8,21,44
485,Tyler Ulis\ulisty01,PG,23,CHI,1,0,1,0,0,,0,0,,0,0,,,0,0,,0,0,0,0,0,0,0,0,0
22,Ryan Arcidiacono\arcidry01,PG,24,CHI,79,30,1899,179,400,0.448,79,211,0.374,100,189,0.529,0.546,79,91,0.868,25,182,207,260,62,4,61,167,516
95,Alex Caruso\carusal01,PG,24,LAL,24,3,491,72,157,0.459,24,48,0.5,48,109,0.44,0.535,49,62,0.79,18,42,60,64,23,8,35,51,217
149,Kris Dunn\dunnkr01,PG,24,CHI,46,44,1389,215,506,0.425,34,96,0.354,181,410,0.441,0.458,55,69,0.797,19,168,187,277,68,21,104,166,519
213,Andrew Harrison\harrian01,PG,24,TOT,17,0,187,16,53,0.302,5,25,0.2,11,28,0.393,0.349,17,18,0.944,6,14,20,24,4,2,12,34,54
213,Andrew Harrison\harrian01,PG,24,MEM,1,0,5,1,2,0.5,0,1,0.0,1,1,1.0,0.5,0,0,,0,0,0,0,0,0,0,1,2
213,Andrew Harrison\harrian01,PG,24,CLE,10,0,144,12,39,0.308,3,14,0.214,9,25,0.36,0.346,16,16,1.0,4,11,15,17,4,2,10,26,43
213,Andrew Harrison\harrian01,PG,24,NOP,6,0,38,3,12,0.25,2,10,0.2,1,2,0.5,0.333,1,2,0.5,2,3,5,7,0,0,2,7,9
251,Demetrius Jackson\jacksde01,PG,24,PHI,6,0,39,8,15,0.533,2,6,0.333,6,9,0.667,0.6,4,4,1.0,2,1,3,5,2,0,1,4,22
327,Frank Mason\masonfr01,PG,24,SAC,37,0,418,65,156,0.417,12,58,0.207,53,98,0.541,0.455,38,55,0.691,4,37,41,83,16,4,34,33,180
398,Cameron Payne\payneca01,PG,24,TOT,40,13,712,96,223,0.43,25,84,0.298,71,139,0.511,0.487,33,41,0.805,13,59,72,106,28,9,45,64,250
398,Cameron Payne\payneca01,PG,24,CHI,31,12,536,69,168,0.411,16,59,0.271,53,109,0.486,0.458,22,25,0.88,10,43,53,83,20,6,34,49,176
398,Cameron Payne\payneca01,PG,24,CLE,9,1,176,27,55,0.491,9,25,0.36,18,30,0.6,0.573,11,16,0.688,3,16,19,23,8,3,11,15,74
399,Elfrid Payton\paytoel01,PG,24,NOP,41,41,1225,178,408,0.436,33,104,0.317,145,304,0.477,0.477,54,72,0.75,48,166,214,313,44,16,110,80,443
429,Terry Rozier\roziete01,PG,24,BOS,78,13,1767,250,651,0.384,115,329,0.35,135,322,0.419,0.472,72,91,0.791,32,271,303,227,67,21,68,101,687
488,Fred VanVleet\vanvlfr01,PG,24,TOR,63,27,1733,240,588,0.408,110,291,0.378,130,297,0.438,0.502,95,113,0.841,21,144,165,303,54,20,81,109,685
497,Tyrone Wallace\wallaty01,PG,24,LAC,61,0,619,90,214,0.421,4,19,0.211,86,195,0.441,0.43,30,57,0.526,20,79,99,41,21,7,36,83,214
505,Derrick White\whitede01,PG,24,SAS,66,54,1700,254,535,0.475,46,140,0.329,208,395,0.527,0.518,95,123,0.772,35,206,241,260,66,47,97,142,649
114,Quinn Cook\cookqu01,PG,25,GSW,72,9,1007,193,415,0.465,77,193,0.399,116,222,0.523,0.558,17,23,0.739,22,129,151,110,20,3,47,84,480
140,Spencer Dinwiddie\dinwisp01,PG,25,BRK,67,4,1889,363,820,0.443,122,363,0.336,241,457,0.527,0.517,287,356,0.806,26,140,166,306,40,17,150,185,1135
167,Yogi Ferrell\ferreyo01,PG,25,SAC,70,3,1038,146,339,0.431,51,143,0.357,95,196,0.485,0.506,60,67,0.896,12,96,108,135,36,4,39,62,403
214,Shaquille Harrison\harrish01,PG,25,CHI,71,9,1382,174,404,0.431,23,85,0.271,151,319,0.473,0.459,79,119,0.664,33,179,212,136,88,26,59,123,450
313,Jordan Loyd\loydjo01,PG,25,TOR,11,0,47,6,14,0.429,3,7,0.429,3,7,0.429,0.536,8,10,0.8,1,7,8,6,0,0,2,5,23
413,Chasson Randle\randlch01,PG,25,WAS,48,2,716,89,210,0.424,44,109,0.404,45,101,0.446,0.529,40,58,0.69,10,44,54,94,25,3,41,88,262
437,Dennis Schroder\schrode01,PG,25,OKC,77,13,2245,444,1075,0.413,114,345,0.33,330,730,0.452,0.466,180,221,0.814,36,238,274,319,61,12,167,182,1182
81,Trey Burke\burketr01,PG,26,TOT,56,8,1100,232,538,0.431,52,151,0.344,180,387,0.465,0.48,103,124,0.831,28,69,97,155,32,7,49,56,619
81,Trey Burke\burketr01,PG,26,NYK,33,7,689,148,358,0.413,30,86,0.349,118,272,0.434,0.455,62,75,0.827,15,47,62,94,21,5,29,33,388
81,Trey Burke\burketr01,PG,26,DAL,23,1,411,84,180,0.467,22,65,0.338,62,115,0.539,0.528,41,49,0.837,13,22,35,61,11,2,20,23,231
195,Jerian Grant\grantje02,PG,26,ORL,60,1,939,92,220,0.418,40,110,0.364,52,110,0.473,0.509,26,40,0.65,19,79,98,156,44,6,51,78,250
248,Kyrie Irving\irvinky01,PG,26,BOS,67,67,2214,604,1241,0.487,174,434,0.401,430,807,0.533,0.557,214,245,0.873,71,264,335,464,103,34,172,167,1596
266,Tyler Johnson\johnsty01,PG,26,TOT,57,22,1529,217,526,0.413,90,260,0.346,127,266,0.477,0.498,95,127,0.748,34,139,173,166,54,27,77,97,619
266,Tyler Johnson\johnsty01,PG,26,MIA,44,10,1123,171,401,0.426,72,204,0.353,99,197,0.503,0.516,61,88,0.693,19,102,121,112,40,21,63,72,475
266,Tyler Johnson\johnsty01,PG,26,PHO,13,12,406,46,125,0.368,18,56,0.321,28,69,0.406,0.44,34,39,0.872,15,37,52,54,14,6,14,25,144
298,Walt Lemon\lemonwa01,PG,26,CHI,4,3,121,26,59,0.441,0,3,0.0,26,56,0.464,0.441,5,8,0.625,1,16,17,24,11,1,7,9,57
333,T.J. McConnell\mccontj01,PG,26,PHI,74,2,1424,210,403,0.521,14,42,0.333,196,361,0.543,0.538,29,37,0.784,28,142,170,252,77,16,88,103,463
372,Raul Neto\netora01,PG,26,UTA,37,1,474,74,161,0.46,20,60,0.333,54,101,0.535,0.522,28,33,0.848,6,56,62,93,14,4,35,49,196
400,Gary Payton\paytoga02,PG,26,WAS,3,0,16,5,8,0.625,1,2,0.5,4,6,0.667,0.688,0,0,,1,1,2,4,3,1,1,2,11
520,Delon Wright\wrighde01,PG,26,TOT,73,11,1625,235,541,0.434,47,161,0.292,188,380,0.495,0.478,108,138,0.783,64,182,246,235,84,30,71,101,625
520,Delon Wright\wrighde01,PG,26,TOR,49,2,897,127,293,0.433,30,90,0.333,97,203,0.478,0.485,53,61,0.869,39,86,125,110,46,15,37,53,337
520,Delon Wright\wrighde01,PG,26,MEM,24,9,728,108,248,0.435,17,71,0.239,91,177,0.514,0.47,55,77,0.714,25,96,121,125,38,15,34,48,288
88,Isaiah Canaan\canaais01,PG,27,TOT,30,16,629,64,164,0.39,34,96,0.354,30,68,0.441,0.494,19,24,0.792,6,52,58,84,14,2,35,52,181
88,Isaiah Canaan\canaais01,PG,27,PHO,19,15,503,51,129,0.395,25,72,0.347,26,57,0.456,0.492,15,20,0.75,5,44,49,62,12,0,29,46,142
88,Isaiah Canaan\canaais01,PG,27,MIN,7,1,95,11,29,0.379,7,19,0.368,4,10,0.4,0.5,4,4,1.0,0,5,5,19,2,1,4,4,33
88,Isaiah Canaan\canaais01,PG,27,MIL,4,0,31,2,6,0.333,2,5,0.4,0,1,0.0,0.5,0,0,,1,3,4,3,0,1,2,2,6
94,Michael Carter-Williams\cartemi01,PG,27,TOT,27,1,350,43,118,0.364,10,37,0.27,33,81,0.407,0.407,30,49,0.612,18,48,66,63,19,15,20,45,126
94,Michael Carter-Williams\cartemi01,PG,27,HOU,16,1,145,25,61,0.41,7,19,0.368,18,42,0.429,0.467,12,26,0.462,3,10,13,21,9,6,10,27,69
94,Michael Carter-Williams\cartemi01,PG,27,ORL,11,0,205,18,57,0.316,3,18,0.167,15,39,0.385,0.342,18,23,0.783,15,38,53,42,10,9,10,18,57
276,Cory Joseph\josepco01,PG,27,IND,81,9,2043,224,541,0.414,55,170,0.324,169,371,0.456,0.465,28,41,0.683,38,238,276,319,92,21,80,130,531
283,Brandon Knight\knighbr03,PG,27,TOT,38,25,705,96,250,0.384,38,124,0.306,58,126,0.46,0.46,27,34,0.794,9,45,54,69,21,2,28,60,257
283,Brandon Knight\knighbr03,PG,27,HOU,12,0,118,11,47,0.234,5,32,0.156,6,15,0.4,0.287,9,11,0.818,1,8,9,9,2,0,5,14,36
283,Brandon Knight\knighbr03,PG,27,CLE,26,25,587,85,203,0.419,33,92,0.359,52,111,0.468,0.5,18,23,0.783,8,37,45,60,19,2,23,46,221
371,Shabazz Napier\napiesh01,PG,27,BRK,55,2,953,162,418,0.388,70,215,0.326,92,203,0.453,0.471,115,138,0.833,15,80,95,138,41,16,66,64,509
436,Tomas Satoransky\satorto01,PG,27,WAS,79,53,2136,251,523,0.48,61,160,0.381,190,363,0.523,0.538,127,154,0.825,82,193,275,394,82,13,118,171,690
75,Lorenzo Brown\brownlo01,PG,28,TOR,26,0,212,23,71,0.324,6,28,0.214,17,43,0.395,0.366,3,3,1.0,5,26,31,28,12,5,16,22,55
133,Matthew Dellavedova\dellama01,PG,28,TOT,48,0,812,98,242,0.405,44,130,0.338,54,112,0.482,0.496,42,52,0.808,6,71,77,181,14,2,68,75,282
133,Matthew Dellavedova\dellama01,PG,28,MIL,12,0,97,6,19,0.316,4,11,0.364,2,8,0.25,0.421,4,4,1.0,0,10,10,29,2,0,11,9,20
133,Matthew Dellavedova\dellama01,PG,28,CLE,36,0,715,92,223,0.413,40,119,0.336,52,104,0.5,0.502,38,48,0.792,6,61,67,152,12,2,57,66,262
173,Tim Frazier\fraziti01,PG,28,TOT,58,18,1072,106,238,0.445,33,95,0.347,73,143,0.51,0.515,36,47,0.766,40,122,162,235,30,4,73,110,281
173,Tim Frazier\fraziti01,PG,28,NOP,47,17,909,88,195,0.451,27,77,0.351,61,118,0.517,0.521,32,41,0.78,32,105,137,206,25,4,60,93,235
173,Tim Frazier\fraziti01,PG,28,MIL,11,1,163,18,43,0.419,6,18,0.333,12,25,0.48,0.488,4,6,0.667,8,17,25,29,5,0,13,17,46
256,Reggie Jackson\jacksre01,PG,28,DET,80,80,2241,430,1019,0.422,169,460,0.367,261,559,0.467,0.505,198,230,0.861,44,167,211,332,54,9,144,204,1227
304,Damian Lillard\lillada01,PG,28,POR,79,79,2802,675,1517,0.445,234,633,0.37,441,884,0.499,0.522,463,508,0.911,67,300,367,543,85,33,209,148,2047
318,Scott Machado\machasc01,PG,28,LAL,4,0,19,4,6,0.667,1,1,1.0,3,5,0.6,0.75,1,1,1.0,0,0,0,3,1,0,0,2,10
319,Shelvin Mack\macksh01,PG,28,TOT,57,3,1246,163,403,0.404,46,130,0.354,117,273,0.429,0.462,58,84,0.69,18,86,104,183,47,4,66,84,430
319,Shelvin Mack\macksh01,PG,28,MEM,53,3,1204,161,389,0.414,46,128,0.359,115,261,0.441,0.473,53,75,0.707,18,84,102,182,45,4,62,81,421
319,Shelvin Mack\macksh01,PG,28,CHO,4,0,42,2,14,0.143,0,2,0.0,2,12,0.167,0.143,5,9,0.556,0,2,2,1,2,0,4,3,9
430,Ricky Rubio\rubiori01,PG,28,UTA,68,67,1899,295,730,0.404,79,254,0.311,216,476,0.454,0.458,195,228,0.855,33,210,243,416,91,10,180,180,864
494,Kemba Walker\walkeke02,PG,28,CHO,80,80,2795,706,1641,0.43,252,712,0.354,454,929,0.489,0.507,372,441,0.844,52,304,356,472,102,32,207,128,2036
496,John Wall\walljo01,PG,28,WAS,32,32,1104,245,552,0.444,51,169,0.302,194,383,0.507,0.49,122,175,0.697,15,101,116,279,49,29,121,71,663
54,Eric Bledsoe\bledser01,PG,29,MIL,78,78,2272,470,971,0.484,124,377,0.329,346,594,0.582,0.548,177,236,0.75,82,280,362,430,116,29,165,156,1241
206,James Harden\hardeja01,PG,29,HOU,77,77,2830,832,1881,0.442,373,1013,0.368,459,868,0.529,0.541,742,845,0.878,65,442,507,583,157,57,383,240,2779
314,Kalin Lucas\lucaska01,PG,29,DET,1,0,6,0,1,0.0,0,1,0.0,0,0,,0.0,2,2,1.0,0,3,3,1,0,0,0,1,2
499,Brad Wanamaker\wanambr01,PG,29,BOS,35,0,314,44,92,0.478,16,35,0.457,28,57,0.491,0.565,19,21,0.905,3,32,35,49,11,2,18,31,123
37,Jerryd Bayless\bayleje01,PG,30,MIN,34,6,657,82,230,0.357,29,98,0.296,53,132,0.402,0.42,16,28,0.571,11,51,62,119,18,2,32,56,209
49,Patrick Beverley\beverpa01,PG,30,LAC,77,48,2115,189,468,0.404,108,275,0.393,81,193,0.42,0.519,96,123,0.78,76,306,382,294,66,43,84,261,582
124,Stephen Curry\curryst01,PG,30,GSW,68,68,2322,630,1336,0.472,353,808,0.437,277,528,0.525,0.604,263,287,0.916,45,323,368,360,92,25,190,166,1876
305,Jeremy Lin\linje01,PG,30,TOT,73,4,1417,236,533,0.443,55,183,0.301,181,350,0.517,0.494,172,206,0.835,21,154,175,226,46,13,121,142,699
305,Jeremy Lin\linje01,PG,30,ATL,51,1,1003,180,386,0.466,44,132,0.333,136,254,0.535,0.523,142,168,0.845,16,103,119,181,38,7,98,96,546
305,Jeremy Lin\linje01,PG,30,TOR,22,3,414,56,147,0.381,11,51,0.216,45,96,0.469,0.418,30,38,0.789,5,51,56,45,8,6,23,46,153
348,Patty Mills\millspa02,PG,30,SAS,81,1,1889,281,658,0.427,159,402,0.396,122,256,0.477,0.548,86,101,0.851,24,155,179,240,49,10,92,127,807
427,Derrick Rose\rosede01,PG,30,MIN,51,13,1392,363,753,0.482,54,146,0.37,309,607,0.509,0.518,137,160,0.856,33,107,140,220,31,12,82,57,917
452,Ish Smith\smithis01,PG,30,DET,54,0,1207,195,469,0.416,43,129,0.333,152,340,0.447,0.462,44,57,0.772,23,118,141,195,28,11,60,105,477
465,Jeff Teague\teaguje01,PG,30,MIN,42,41,1264,176,416,0.423,35,105,0.333,141,311,0.453,0.465,123,153,0.804,16,90,106,343,43,18,97,90,510
482,Evan Turner\turneev01,PG,30,POR,72,2,1589,202,438,0.461,11,52,0.212,191,386,0.495,0.474,73,104,0.702,37,288,325,280,33,17,113,110,488
504,Russell Westbrook\westbru01,PG,30,OKC,71,71,2556,612,1440,0.425,114,398,0.286,498,1042,0.478,0.465,293,446,0.657,107,677,784,757,141,32,318,238,1631
24,D.J. Augustin\augusdj01,PG,31,ORL,80,80,2238,311,664,0.468,128,305,0.42,183,359,0.51,0.565,180,207,0.87,41,158,199,425,52,4,126,113,930
110,Darren Collison\collida01,PG,31,IND,75,75,2127,307,656,0.468,79,193,0.409,228,463,0.492,0.528,154,186,0.828,36,195,231,455,109,9,124,135,847
112,Mike Conley\conlemi01,PG,31,MEM,70,70,2342,490,1120,0.438,155,426,0.364,335,694,0.483,0.507,343,406,0.845,40,199,239,449,94,22,130,123,1478
467,Milos Teodosic\teodomi01,PG,31,LAC,15,0,150,17,40,0.425,10,27,0.37,7,13,0.538,0.55,4,7,0.571,3,13,16,32,3,1,21,27,48
146,Goran Dragic\dragigo01,PG,32,MIA,34,20,950,177,420,0.421,56,161,0.348,121,259,0.467,0.488,78,99,0.788,18,88,106,161,28,5,68,79,488
227,George Hill\hillge01,PG,32,TOT,59,13,1283,169,371,0.456,47,148,0.318,122,223,0.547,0.519,69,83,0.831,39,108,147,134,50,8,51,102,454
227,George Hill\hillge01,PG,32,CLE,13,13,344,55,107,0.514,13,28,0.464,42,79,0.532,0.575,17,20,0.85,12,15,27,36,12,1,20,35,140
227,George Hill\hillge01,PG,32,MIL,46,0,939,114,264,0.432,34,120,0.283,80,144,0.556,0.496,52,63,0.825,27,93,120,98,38,7,31,67,314
312,Kyle Lowry\lowryky01,PG,32,TOR,65,65,2213,304,739,0.411,157,453,0.347,147,286,0.514,0.518,161,194,0.83,41,271,312,564,91,31,182,166,926
426,Rajon Rondo\rondora01,PG,32,LAL,46,29,1369,175,432,0.405,51,142,0.359,124,290,0.428,0.464,23,36,0.639,34,209,243,367,57,7,127,100,424
306,Shaun Livingston\livinsh01,PG,33,GSW,63,0,951,109,209,0.522,0,2,0.0,109,207,0.527,0.522,40,49,0.816,41,73,114,114,31,27,38,73,258
397,Chris Paul\paulch01,PG,33,HOU,57,57,1823,293,705,0.416,122,346,0.353,171,359,0.476,0.502,174,202,0.861,35,223,258,467,112,18,150,144,882
32,J.J. Barea\bareajo01,PG,34,DAL,38,0,752,161,385,0.418,38,128,0.297,123,257,0.479,0.468,55,78,0.705,13,82,95,211,22,1,72,50,415
165,Raymond Felton\feltora01,PG,34,OKC,31,0,345,50,124,0.403,15,52,0.288,35,72,0.486,0.464,12,13,0.923,4,26,30,43,10,6,13,27,127
209,Devin Harris\harride01,PG,35,DAL,66,0,1015,123,326,0.377,59,191,0.309,64,135,0.474,0.468,97,129,0.752,11,96,107,113,35,13,52,126,402
393,Tony Parker\parketo01,PG,36,CHO,56,0,1003,213,463,0.46,13,51,0.255,200,412,0.485,0.474,91,124,0.734,14,69,83,207,21,7,75,53,530
86,Jose Calderon\caldejo01,PG,37,DET,48,0,628,45,119,0.378,14,56,0.25,31,63,0.492,0.437,9,11,0.818,11,49,60,115,16,3,35,63,113
92,Vince Carter\cartevi01,SF,42,ATL,75,9,1318,196,464,0.422,123,313,0.393,73,151,0.483,0.555,46,64,0.719,31,163,194,87,44,26,48,139,561
77,Troy Brown\browntr01,SF,19,WAS,51,9,711,95,226,0.42,21,65,0.323,74,161,0.46,0.467,32,47,0.681,35,106,141,78,21,5,27,55,243
67,Miles Bridges\bridgmi02,SF,20,CHO,78,23,1627,223,489,0.456,61,191,0.319,162,298,0.544,0.518,54,72,0.75,65,246,311,88,53,44,48,111,561
289,Rodions Kurucs\kurucro01,SF,20,BRK,62,45,1266,197,434,0.454,57,176,0.324,140,258,0.543,0.52,68,88,0.773,53,184,237,51,39,25,77,145,519
464,Jayson Tatum\tatumja01,SF,20,BOS,79,79,2455,466,1036,0.45,116,311,0.373,350,725,0.483,0.506,195,228,0.855,70,407,477,168,84,57,122,168,1243
6,Deng Adel\adelde01,SF,21,CLE,18,3,190,11,36,0.306,6,23,0.261,5,13,0.385,0.389,4,4,1.0,3,16,19,5,1,4,6,13,32
21,OG Anunoby\anunoog01,SF,21,TOR,66,6,1334,179,398,0.45,66,200,0.33,113,198,0.571,0.533,36,62,0.581,57,135,192,45,46,22,53,138,460
247,Brandon Ingram\ingrabr01,SF,21,LAL,52,52,1760,362,729,0.497,31,94,0.33,331,635,0.521,0.518,195,289,0.675,41,226,267,154,28,31,129,149,950
270,Derrick Jones\jonesde02,SF,21,MIA,58,14,1092,153,313,0.489,28,90,0.311,125,223,0.561,0.534,68,113,0.602,94,139,233,36,46,41,42,121,402
368,Sviatoslav Mykhailiuk\mykhasv01,SF,21,TOT,42,0,440,46,140,0.329,29,89,0.326,17,51,0.333,0.432,12,20,0.6,9,27,36,37,14,1,21,25,133
368,Sviatoslav Mykhailiuk\mykhasv01,SF,21,LAL,39,0,420,44,132,0.333,27,85,0.318,17,47,0.362,0.436,12,20,0.6,8,26,34,33,13,1,20,25,127
368,Sviatoslav Mykhailiuk\mykhasv01,SF,21,DET,3,0,20,2,8,0.25,2,4,0.5,0,4,0.0,0.375,0,0,,1,1,2,4,1,0,1,0,6
66,Mikal Bridges\bridgmi01,SF,22,PHO,81,55,2380,238,557,0.427,105,312,0.337,133,245,0.543,0.522,93,115,0.809,55,208,263,173,126,38,70,200,674
152,Vince Edwards\edwarvi01,SF,22,HOU,2,0,16,1,4,0.25,1,4,0.25,0,0,,0.375,0,0,,1,1,2,0,0,0,0,0,3
225,Haywood Highsmith\highsha01,SF,22,PHI,3,0,15,2,5,0.4,1,3,0.333,1,2,0.5,0.5,0,0,,0,3,3,2,0,0,0,1,5
241,Chandler Hutchison\hutchch01,SF,22,CHI,44,14,895,96,209,0.459,14,50,0.28,82,159,0.516,0.493,23,38,0.605,31,154,185,34,23,6,25,59,229
265,Stanley Johnson\johnsst04,SF,22,TOT,66,7,1208,171,440,0.389,62,215,0.288,109,225,0.484,0.459,50,64,0.781,34,183,217,88,60,14,81,114,454
265,Stanley Johnson\johnsst04,SF,22,DET,48,7,961,133,349,0.381,51,181,0.282,82,168,0.488,0.454,41,51,0.804,25,150,175,60,48,13,55,92,358
265,Stanley Johnson\johnsst04,SF,22,NOP,18,0,247,38,91,0.418,11,34,0.324,27,57,0.474,0.478,9,13,0.692,9,33,42,28,12,1,26,22,96
518,Justise Winslow\winslju01,SF,22,MIA,64,50,1908,315,731,0.431,91,245,0.371,224,486,0.461,0.493,85,135,0.63,62,285,347,276,68,18,139,170,806
35,Keita Bates-Diop\bateske01,SF,23,MIN,28,3,461,56,131,0.427,12,47,0.255,44,84,0.524,0.473,16,26,0.615,15,57,72,15,16,12,10,27,140
71,Dillon Brooks\brookdi01,SF,23,MEM,18,0,330,49,122,0.402,15,40,0.375,34,82,0.415,0.463,22,30,0.733,9,22,31,16,10,4,19,50,135
85,Bruno Caboclo\cabocbr01,SF,23,MEM,32,17,743,82,198,0.414,43,118,0.364,39,80,0.488,0.523,39,47,0.83,42,109,151,46,12,31,35,73,246
111,Bonzie Colson\colsobo01,SF,23,MIL,7,1,54,6,23,0.261,2,12,0.167,4,11,0.364,0.304,4,4,1.0,6,14,20,3,2,1,1,3,18
196,Donte Grantham\grantdo01,SF,23,OKC,3,0,2,0,2,0.0,0,2,0.0,0,0,,0.0,0,0,,0,0,0,0,0,0,0,0,0
222,Mario Hezonja\hezonma01,SF,23,NYK,57,23,1185,191,461,0.414,42,151,0.278,149,310,0.481,0.46,87,114,0.763,28,208,236,84,54,8,82,107,511
255,Justin Jackson\jacksju01,SF,23,TOT,79,12,1558,207,469,0.441,83,238,0.349,124,231,0.537,0.53,62,79,0.785,42,168,210,94,31,14,27,95,559
255,Justin Jackson\jacksju01,SF,23,SAC,52,3,1083,125,295,0.424,55,159,0.346,70,136,0.515,0.517,41,50,0.82,25,121,146,68,23,13,22,67,346
255,Justin Jackson\jacksju01,SF,23,DAL,27,9,475,82,174,0.471,28,79,0.354,54,95,0.568,0.552,21,29,0.724,17,47,64,26,8,1,5,28,213
263,B.J. Johnson\johnsbj01,SF,23,ATL,6,0,43,8,16,0.5,3,6,0.5,5,10,0.5,0.594,2,2,1.0,2,6,8,0,2,0,2,3,21
272,Jemerrio Jones\jonesje01,SF,23,LAL,5,1,97,7,20,0.35,1,8,0.125,6,12,0.5,0.375,1,2,0.5,10,24,34,10,5,4,4,8,16
315,Timothe Luwawu-Cabarrot\luwawti01,SF,23,TOT,48,5,615,74,197,0.376,33,107,0.308,41,90,0.456,0.459,26,35,0.743,11,78,89,24,19,8,21,65,207
315,Timothe Luwawu-Cabarrot\luwawti01,SF,23,OKC,21,1,123,13,43,0.302,5,22,0.227,8,21,0.381,0.36,4,6,0.667,4,14,18,4,4,1,5,14,35
315,Timothe Luwawu-Cabarrot\luwawti01,SF,23,CHI,27,4,492,61,154,0.396,28,85,0.329,33,69,0.478,0.487,22,29,0.759,7,64,71,20,15,7,16,51,172
389,Cedi Osman\osmande01,SF,23,CLE,75,74,2407,353,830,0.425,128,369,0.347,225,461,0.488,0.502,140,179,0.782,44,309,353,194,59,11,113,193,974
390,Kelly Oubre\oubreke01,SF,23,TOT,69,19,1935,375,842,0.445,108,338,0.32,267,504,0.53,0.51,189,244,0.775,71,254,325,84,84,59,103,181,1047
390,Kelly Oubre\oubreke01,SF,23,WAS,29,7,755,132,305,0.433,41,132,0.311,91,173,0.526,0.5,68,85,0.8,24,105,129,20,27,20,30,71,373
390,Kelly Oubre\oubreke01,SF,23,PHO,40,12,1180,243,537,0.453,67,206,0.325,176,331,0.532,0.515,121,159,0.761,47,149,196,64,57,39,73,110,674
421,Devin Robinson\robinde01,SF,23,WAS,6,0,64,12,22,0.545,0,1,0.0,12,21,0.571,0.545,9,14,0.643,3,12,15,3,4,5,0,7,33
508,Andrew Wiggins\wiggian01,SF,23,MIN,71,71,2478,480,1172,0.41,113,336,0.336,367,836,0.439,0.458,207,295,0.702,82,262,344,177,70,46,135,152,1280
233,Rondae Hollis-Jefferson\holliro01,SF,24,BRK,58,21,1208,195,469,0.416,9,47,0.191,186,422,0.441,0.425,118,183,0.645,78,220,298,93,41,26,65,106,517
250,Wesley Iwundu\iwundwe01,SF,24,ORL,67,12,1209,110,268,0.41,28,77,0.364,82,191,0.429,0.463,84,103,0.816,37,147,184,69,26,20,44,122,332
294,Jake Layman\laymaja01,SF,24,POR,69,32,1270,209,405,0.516,57,176,0.324,152,229,0.664,0.586,47,66,0.712,56,155,211,51,30,30,42,112,522
303,Caris LeVert\leverca01,SF,24,BRK,39,24,1043,203,478,0.425,47,153,0.307,156,325,0.48,0.474,84,122,0.689,34,114,148,152,42,14,67,75,537
498,Taurean Waller-Prince\princta02,SF,24,ATL,54,46,1519,254,577,0.44,118,307,0.384,136,270,0.504,0.542,93,113,0.823,22,172,194,116,53,18,99,139,719
502,Yuta Watanabe\watanyu01,SF,24,MEM,14,0,155,13,43,0.302,2,13,0.154,11,30,0.367,0.326,7,10,0.7,2,25,27,8,4,1,6,9,35
512,Kenrich Williams\willike04,SF,24,NOP,45,28,1045,104,269,0.387,50,149,0.336,54,120,0.45,0.48,13,19,0.684,52,160,212,77,40,19,36,94,271
516,Troy Williams\willitr02,SF,24,SAC,20,0,301,42,93,0.452,14,43,0.326,28,50,0.56,0.527,9,15,0.6,10,47,57,11,10,8,9,34,107
14,Justin Anderson\anderju01,SF,25,ATL,47,4,451,62,154,0.403,23,76,0.303,39,78,0.5,0.477,24,33,0.727,23,58,81,23,21,13,21,46,171
15,Kyle Anderson\anderky01,SF,25,MEM,43,40,1281,150,276,0.543,9,34,0.265,141,242,0.583,0.56,37,64,0.578,48,203,251,128,54,37,58,112,346
55,Jaron Blossomgame\blossja01,SF,25,CLE,27,4,439,47,106,0.443,10,39,0.256,37,67,0.552,0.491,10,13,0.769,26,72,98,13,7,8,11,20,114
168,Dorian Finney-Smith\finnedo01,SF,25,DAL,79,26,1941,219,509,0.43,77,248,0.31,142,261,0.544,0.506,73,103,0.709,131,245,376,91,68,36,72,181,588
207,Maurice Harkless\harklma01,SF,25,POR,59,52,1381,180,374,0.481,32,116,0.276,148,258,0.574,0.524,42,65,0.646,74,187,261,74,67,49,45,161,434
237,Danuel House\houseda01,SF,25,HOU,38,13,955,118,248,0.476,74,174,0.425,44,74,0.595,0.625,56,71,0.789,25,113,138,39,20,11,35,77,366
271,Jalen Jones\jonesja04,SF,25,CLE,16,0,214,26,62,0.419,10,28,0.357,16,34,0.471,0.5,19,27,0.704,11,23,34,7,9,2,8,27,81
281,George King\kingge03,SF,25,PHO,1,0,6,0,0,,0,0,,0,0,,,0,0,,0,1,1,0,0,0,0,0,0
347,Malcolm Miller\millema01,SF,25,TOR,9,0,58,10,24,0.417,10,21,0.476,0,3,0.0,0.625,2,2,1.0,0,4,4,1,1,1,1,4,32
369,Abdel Nader\naderab01,SF,25,OKC,60,1,679,86,203,0.424,31,94,0.33,55,109,0.505,0.5,27,35,0.771,12,96,108,18,19,12,24,67,230
381,Royce O'Neale\onealro01,SF,25,UTA,80,14,1610,157,330,0.476,67,168,0.399,90,162,0.556,0.577,31,41,0.756,22,255,277,121,54,23,68,167,412
406,Otto Porter\porteot01,SF,25,TOT,56,43,1683,299,643,0.465,104,256,0.406,195,387,0.504,0.546,78,96,0.813,54,260,314,120,82,31,65,108,780
406,Otto Porter\porteot01,SF,25,WAS,41,28,1191,202,442,0.457,65,176,0.369,137,266,0.515,0.531,49,64,0.766,40,191,231,80,64,22,40,79,518
406,Otto Porter\porteot01,SF,25,CHI,15,15,492,97,201,0.483,39,80,0.488,58,121,0.479,0.58,29,32,0.906,14,69,83,40,18,9,25,29,262
423,Glenn Robinson\robingl02,SF,25,DET,45,18,568,70,167,0.419,17,59,0.288,53,108,0.491,0.47,31,38,0.816,17,44,61,19,12,7,18,43,188
434,JaKarr Sampson\sampsja02,SF,25,CHI,3,0,94,25,38,0.658,4,9,0.444,21,29,0.724,0.711,15,17,0.882,4,20,24,3,3,3,3,7,69
500,T.J. Warren\warretj01,SF,25,PHO,43,36,1360,297,611,0.486,77,180,0.428,220,431,0.51,0.549,101,124,0.815,31,143,174,64,51,29,52,119,772
33,Harrison Barnes\barneha02,SF,26,SAC,27,27,933,139,306,0.454,51,127,0.402,88,179,0.492,0.538,60,74,0.811,21,130,151,50,17,2,30,43,389
120,Mitch Creek\creekmi01,SF,26,BRK,4,0,36,5,10,0.5,0,1,0.0,5,9,0.556,0.5,5,7,0.714,5,5,10,5,1,0,0,3,15
337,Alfonzo McKinnie\mckinal01,SF,26,GSW,70,4,956,129,265,0.487,41,114,0.36,88,151,0.583,0.564,24,43,0.558,81,156,237,29,16,15,29,129,323
228,Solomon Hill\hillso01,SF,27,NOP,43,15,857,66,171,0.386,31,97,0.32,35,74,0.473,0.477,23,32,0.719,34,96,130,51,22,10,30,79,186
300,Kawhi Leonard\leonaka01,SF,27,TOR,59,59,2016,552,1115,0.495,108,295,0.366,444,820,0.541,0.543,364,426,0.854,78,355,433,198,105,23,120,87,1576
334,Doug McDermott\mcderdo01,SF,27,IND,76,0,1308,203,410,0.495,82,203,0.404,121,207,0.585,0.595,63,76,0.829,16,88,104,65,17,8,42,102,551
344,Khris Middleton\middlkh01,SF,27,MIL,76,76,2377,497,1134,0.438,176,467,0.377,321,667,0.481,0.516,216,258,0.837,50,410,460,326,79,7,173,170,1386
456,Tony Snell\snellto01,SF,27,MIL,74,12,1304,163,361,0.452,81,204,0.397,82,157,0.522,0.564,37,42,0.881,29,128,157,68,26,18,23,90,444
501,Julian Washburn\washbju01,SF,27,MEM,16,3,218,11,40,0.275,4,21,0.19,7,19,0.368,0.325,3,4,0.75,7,26,33,14,10,2,6,13,29
116,Robert Covington\covinro01,SF,28,TOT,35,35,1203,156,362,0.431,85,225,0.378,71,137,0.518,0.548,68,89,0.764,28,165,193,46,74,47,47,126,465
116,Robert Covington\covinro01,SF,28,PHI,13,13,440,50,117,0.427,30,77,0.39,20,40,0.5,0.556,17,23,0.739,7,60,67,14,24,23,22,45,147
116,Robert Covington\covinro01,SF,28,MIN,22,22,763,106,245,0.433,55,148,0.372,51,97,0.526,0.545,51,66,0.773,21,105,126,32,50,24,25,81,318
118,Torrey Craig\craigto01,SF,28,DEN,73,37,1469,158,359,0.44,59,185,0.319,99,174,0.569,0.522,48,68,0.706,88,172,260,69,37,46,43,168,423
121,Jae Crowder\crowdja01,SF,28,UTA,78,10,2125,311,785,0.396,168,514,0.327,143,271,0.528,0.503,137,191,0.717,60,314,374,130,64,28,83,167,927
156,James Ennis\ennisja01,SF,28,TOT,58,27,1230,138,294,0.469,55,156,0.353,83,138,0.601,0.563,58,81,0.716,60,122,182,41,41,23,34,150,389
156,James Ennis\ennisja01,SF,28,HOU,40,25,949,104,211,0.493,44,120,0.367,60,91,0.659,0.597,42,58,0.724,37,80,117,27,38,16,23,111,294
156,James Ennis\ennisja01,SF,28,PHI,18,2,281,34,83,0.41,11,36,0.306,23,47,0.489,0.476,16,23,0.696,23,42,65,14,3,7,11,39,95
183,Paul George\georgpa01,SF,28,OKC,76,76,2799,698,1589,0.439,288,743,0.388,410,846,0.485,0.53,448,534,0.839,104,515,619,315,166,34,203,210,2132
346,Darius Miller\milleda01,SF,28,NOP,69,15,1757,189,484,0.39,133,364,0.365,56,120,0.467,0.528,56,71,0.789,14,114,128,146,40,23,59,165,567
378,James Nunnally\nunnaja01,SF,28,TOT,15,0,102,12,34,0.353,8,25,0.32,4,9,0.444,0.471,4,4,1.0,0,5,5,7,1,0,1,10,36
378,James Nunnally\nunnaja01,SF,28,MIN,13,0,64,9,21,0.429,5,13,0.385,4,8,0.5,0.548,4,4,1.0,0,4,4,5,1,0,1,4,27
378,James Nunnally\nunnaja01,SF,28,HOU,2,0,38,3,13,0.231,3,12,0.25,0,1,0.0,0.346,0,0,,0,1,1,2,0,0,0,6,9
57,Bojan Bogdanovic\bogdabo02,SF,29,IND,81,81,2573,522,1051,0.497,164,386,0.425,358,665,0.538,0.575,246,305,0.807,33,300,333,161,69,1,134,138,1454
84,Jimmy Butler\butleji01,SF,29,PHI,54,54,1808,342,742,0.461,50,147,0.34,292,595,0.491,0.495,264,304,0.868,105,184,289,219,99,29,79,92,998
447,Jonathon Simmons\simmojo02,SF,29,PHI,13,0,163,16,41,0.39,4,12,0.333,12,29,0.414,0.439,13,21,0.619,3,14,17,20,8,0,8,20,49
36,Nicolas Batum\batumni01,SF,30,CHO,73,70,2310,252,559,0.451,115,296,0.389,137,263,0.521,0.554,77,89,0.865,70,312,382,242,71,42,117,140,696
96,Omri Casspi\casspom01,SF,30,MEM,36,0,520,86,161,0.534,15,43,0.349,71,118,0.602,0.581,39,58,0.672,17,98,115,26,20,9,23,35,226
177,Danilo Gallinari\gallida01,SF,30,LAC,67,67,2035,404,873,0.463,161,371,0.434,243,502,0.484,0.555,364,402,0.905,53,360,413,173,48,23,99,128,1333
232,John Holland\hollajo02,SF,30,CLE,1,0,1,0,0,,0,0,,0,0,,,0,0,,0,0,0,0,0,0,0,0,0
394,Chandler Parsons\parsoch01,SF,30,MEM,24,3,466,65,174,0.374,28,92,0.304,37,82,0.451,0.454,20,23,0.87,4,64,68,40,19,5,27,43,178
405,Quincy Pondexter\pondequ01,SF,30,SAS,52,0,289,29,58,0.5,6,18,0.333,23,40,0.575,0.552,34,42,0.81,8,38,46,24,11,1,13,24,98
101,Wilson Chandler\chandwi01,SF,31,LAC,14,1,214,22,63,0.349,13,39,0.333,9,24,0.375,0.452,5,7,0.714,3,43,46,10,3,3,7,28,62
267,Wesley Johnson\johnswe01,SF,31,TOT,38,13,534,45,128,0.352,25,76,0.329,20,52,0.385,0.449,13,19,0.684,12,60,72,23,14,12,18,63,128
267,Wesley Johnson\johnswe01,SF,31,NOP,26,13,377,35,88,0.398,19,50,0.38,16,38,0.421,0.506,6,9,0.667,10,44,54,16,12,7,12,45,95
267,Wesley Johnson\johnswe01,SF,31,WAS,12,0,157,10,40,0.25,6,26,0.231,4,14,0.286,0.325,7,10,0.7,2,16,18,7,2,5,6,18,33
345,C.J. Miles\milescj01,SF,31,TOT,53,1,856,112,311,0.36,67,203,0.33,45,108,0.417,0.468,48,58,0.828,13,82,95,36,26,15,30,79,339
345,C.J. Miles\milescj01,SF,31,TOR,40,1,562,70,206,0.34,43,137,0.314,27,69,0.391,0.444,35,44,0.795,12,56,68,22,18,10,21,62,218
345,C.J. Miles\milescj01,SF,31,MEM,13,0,294,42,105,0.4,24,66,0.364,18,39,0.462,0.514,13,14,0.929,1,26,27,14,8,5,9,17,121
65,Corey Brewer\breweco01,SF,32,TOT,30,3,468,53,123,0.431,14,44,0.318,39,79,0.494,0.488,31,43,0.721,25,50,75,36,30,7,16,61,151
65,Corey Brewer\breweco01,SF,32,PHI,7,3,140,20,49,0.408,4,14,0.286,16,35,0.457,0.449,9,13,0.692,4,13,17,10,12,2,8,16,53
65,Corey Brewer\breweco01,SF,32,SAC,23,0,328,33,74,0.446,10,30,0.333,23,44,0.523,0.514,22,30,0.733,21,37,58,26,18,5,8,45,98
328,Wesley Matthews\matthwe02,SF,32,DAL,44,44,1312,194,469,0.414,100,263,0.38,94,206,0.456,0.52,87,110,0.791,20,82,102,100,33,12,58,102,575
23,Trevor Ariza\arizatr01,SF,33,TOT,69,69,2349,294,736,0.399,145,434,0.334,149,302,0.493,0.498,130,164,0.793,50,321,371,252,91,21,106,130,863
23,Trevor Ariza\arizatr01,SF,33,PHO,26,26,884,86,227,0.379,50,139,0.36,36,88,0.409,0.489,36,43,0.837,16,129,145,87,38,8,39,44,258
23,Trevor Ariza\arizatr01,SF,33,WAS,43,43,1465,208,509,0.409,95,295,0.322,113,214,0.528,0.502,94,121,0.777,34,192,226,165,53,13,67,86,605
134,Luol Deng\denglu01,SF,33,MIN,22,2,392,59,118,0.5,14,44,0.318,45,74,0.608,0.559,25,35,0.714,20,53,73,18,15,8,14,24,157
257,LeBron James\jamesle01,SF,34,LAL,55,55,1937,558,1095,0.51,111,327,0.339,447,768,0.582,0.56,278,418,0.665,57,408,465,454,72,33,197,94,1505
439,Thabo Sefolosha\sefolth01,SF,34,UTA,48,2,570,67,139,0.482,33,76,0.434,34,63,0.54,0.601,14,22,0.636,7,108,115,24,41,5,24,40,181
243,Andre Iguodala\iguodan01,SF,35,GSW,67,13,1556,149,292,0.51,47,138,0.341,102,154,0.662,0.591,39,67,0.582,47,204,251,211,61,51,51,95,384
142,Luka Doncic\doncilu01,SG,19,DAL,71,71,2286,500,1172,0.427,166,509,0.326,334,663,0.504,0.497,339,477,0.711,83,464,547,418,74,25,243,136,1505
366,Dzanan Musa\musadz01,SG,19,BRK,8,0,34,8,20,0.4,0,9,0.0,8,11,0.727,0.4,0,2,0.0,1,3,4,1,2,0,4,1,16
449,Anfernee Simons\simonan01,SG,19,POR,19,0,93,15,42,0.357,3,18,0.167,12,24,0.5,0.393,5,10,0.5,0,7,7,4,0,0,9,7,38
455,Zhaire Smith\smithzh01,SG,19,PHI,4,0,49,3,13,0.231,3,8,0.375,0,5,0.0,0.346,3,4,0.75,1,6,7,3,2,2,3,5,12
138,Hamidou Diallo\diallha01,SG,20,OKC,51,3,526,75,165,0.455,4,24,0.167,71,141,0.504,0.467,36,59,0.61,38,59,97,17,21,10,23,77,190
166,Terrance Ferguson\fergute01,SG,20,OKC,72,72,1872,175,411,0.426,100,275,0.364,75,136,0.551,0.547,36,50,0.72,33,99,132,66,40,16,42,224,486
176,Markelle Fultz\fultzma01,SG,20,PHI,19,15,427,65,155,0.419,4,14,0.286,61,141,0.433,0.432,21,37,0.568,26,44,70,59,17,5,25,52,155
239,Kevin Huerter\huertke01,SG,20,ATL,74,58,2018,269,649,0.414,131,347,0.378,138,302,0.457,0.515,41,56,0.732,59,181,240,211,64,24,106,151,710
354,Malik Monk\monkma01,SG,20,CHO,71,0,1217,223,575,0.388,107,322,0.332,116,253,0.458,0.481,90,102,0.882,15,117,132,110,35,17,84,101,643
386,Josh Okogie\okogijo01,SG,20,MIN,72,50,1722,195,501,0.389,59,212,0.278,136,289,0.471,0.448,118,162,0.728,41,175,216,89,86,33,63,161,567
479,Gary Trent\trentga02,SG,20,POR,14,0,63,8,31,0.258,4,16,0.25,4,15,0.267,0.323,1,4,0.25,1,8,9,2,0,1,3,3,21
495,Lonnie Walker\walkelo01,SG,20,SAS,16,0,114,16,45,0.356,5,13,0.385,11,32,0.344,0.411,8,10,0.8,0,16,16,9,7,2,4,7,45
9,Rawle Alkins\alkinra01,SG,21,CHI,8,1,88,10,32,0.313,3,11,0.273,7,21,0.333,0.359,7,9,0.778,10,13,23,11,1,0,7,6,30
158,Jacob Evans\evansja02,SG,21,GSW,28,0,142,10,36,0.278,1,8,0.125,9,28,0.321,0.292,0,1,0.0,4,13,17,17,2,1,7,23,21
254,Josh Jackson\jacksjo02,SG,21,PHO,78,28,1947,341,821,0.415,71,217,0.327,270,604,0.447,0.459,140,208,0.673,65,274,339,183,74,54,172,206,893
285,Furkan Korkmaz\korkmfu01,SG,21,PHI,46,6,654,94,234,0.402,46,139,0.331,48,95,0.505,0.5,35,42,0.833,16,89,105,51,28,2,25,59,269
424,Jerome Robinson\robinje01,SG,21,LAC,32,0,304,41,104,0.394,18,56,0.321,23,48,0.479,0.481,5,7,0.714,3,32,35,16,11,3,11,42,105
433,Brandon Sampson\sampsbr01,SG,21,CHI,12,2,169,20,45,0.444,7,22,0.318,13,23,0.565,0.522,3,4,0.75,3,11,14,9,4,2,10,15,50
442,Landry Shamet\shamela01,SG,21,TOT,78,26,1772,235,545,0.431,164,388,0.423,71,157,0.452,0.582,74,91,0.813,21,109,130,114,37,10,45,153,708
442,Landry Shamet\shamela01,SG,21,PHI,54,4,1108,153,347,0.441,99,245,0.404,54,102,0.529,0.584,44,54,0.815,14,64,78,59,24,8,26,106,449
442,Landry Shamet\shamela01,SG,21,LAC,24,22,664,82,198,0.414,65,143,0.455,17,55,0.309,0.578,30,37,0.811,7,45,52,55,13,2,19,47,259
41,Malik Beasley\beaslma01,SG,22,DEN,79,18,1831,337,714,0.472,157,392,0.401,180,322,0.559,0.582,54,63,0.857,35,163,198,96,53,9,54,115,885
53,Antonio Blakeney\blakean01,SG,22,CHI,56,3,815,163,390,0.418,36,90,0.4,127,300,0.423,0.464,49,74,0.662,7,98,105,39,11,9,35,40,411
61,Devin Booker\bookede01,SG,22,PHO,64,64,2242,586,1255,0.467,135,414,0.326,451,841,0.536,0.521,393,454,0.866,39,226,265,433,56,13,264,200,1700
73,Bruce Brown\brownbr01,SG,22,DET,72,54,1406,120,306,0.392,24,92,0.261,96,214,0.449,0.431,41,56,0.732,45,133,178,89,38,35,46,172,305
74,Jaylen Brown\brownja02,SG,22,BOS,73,24,1895,362,779,0.465,94,272,0.346,268,507,0.529,0.525,131,198,0.662,64,246,310,98,66,32,96,185,949
141,Donte DiVincenzo\divindo01,SG,22,MIL,27,0,411,50,124,0.403,22,83,0.265,28,41,0.683,0.492,9,12,0.75,16,49,65,31,13,6,19,38,131
143,Tyler Dorsey\dorsety01,SG,22,TOT,46,9,638,95,240,0.396,41,122,0.336,54,118,0.458,0.481,35,57,0.614,23,82,105,50,13,2,23,50,266
143,Tyler Dorsey\dorsety01,SG,22,ATL,27,0,251,32,89,0.36,10,39,0.256,22,50,0.44,0.416,16,26,0.615,9,34,43,17,7,1,10,20,90
143,Tyler Dorsey\dorsety01,SG,22,MEM,19,9,387,63,151,0.417,31,83,0.373,32,68,0.471,0.52,19,31,0.613,14,48,62,33,6,1,13,30,176
145,PJ Dozier\doziepj01,SG,22,BOS,5,0,14,3,7,0.429,1,2,0.5,2,5,0.4,0.5,0,0,,2,4,6,0,0,0,0,1,7
172,Melvin Frazier\frazime01,SG,22,ORL,10,0,44,7,21,0.333,0,6,0.0,7,15,0.467,0.333,1,4,0.25,3,2,5,1,1,0,1,6,15
279,Luke Kennard\kennalu01,SG,22,DET,61,10,1383,214,495,0.432,97,252,0.385,117,243,0.481,0.53,46,56,0.821,12,164,176,111,26,10,53,87,571
350,Shake Milton\miltosh01,SG,22,PHI,18,0,224,28,68,0.412,11,35,0.314,17,33,0.515,0.493,4,5,0.8,7,19,26,15,5,5,6,24,71
352,Donovan Mitchell\mitchdo01,SG,22,UTA,76,76,2562,647,1504,0.43,183,511,0.358,464,993,0.467,0.491,306,380,0.805,57,252,309,318,104,31,214,204,1783
472,Khyri Thomas\thomakh01,SG,22,DET,25,0,190,22,66,0.333,10,35,0.286,12,31,0.387,0.409,7,11,0.636,4,16,20,8,7,5,4,21,61
10,Grayson Allen\allengr01,SG,23,UTA,36,1,362,56,146,0.384,27,84,0.321,29,62,0.468,0.476,30,44,0.682,1,14,15,21,5,5,29,43,169
26,Dwayne Bacon\bacondw01,SG,23,CHO,41,11,695,109,235,0.464,34,79,0.43,75,156,0.481,0.536,34,46,0.739,8,79,87,44,10,5,17,68,286
76,Sterling Brown\brownst02,SG,23,MIL,57,7,1012,143,305,0.469,53,143,0.371,90,162,0.556,0.556,26,38,0.684,28,152,180,81,25,8,43,84,365
203,Daniel Hamilton\hamilda02,SG,23,ATL,19,3,204,23,60,0.383,8,23,0.348,15,37,0.405,0.45,3,6,0.5,10,37,47,22,6,1,16,19,57
215,Josh Hart\hartjo01,SG,23,LAL,67,22,1715,189,464,0.407,92,274,0.336,97,190,0.511,0.506,55,80,0.688,35,213,248,93,64,40,58,147,525
293,Zach LaVine\lavinza01,SG,23,CHI,63,62,2171,530,1135,0.467,120,321,0.374,410,814,0.504,0.52,312,375,0.832,40,254,294,283,60,26,215,140,1492
320,Daryl Macon\maconda01,SG,23,DAL,8,0,90,10,27,0.37,5,11,0.455,5,16,0.313,0.463,4,7,0.571,2,10,12,7,1,0,6,8,29
321,J.P. Macura\macurjp01,SG,23,CHO,1,0,14,2,8,0.25,0,4,0.0,2,4,0.5,0.25,0,0,,0,2,2,2,0,0,0,0,4
331,Patrick McCaw\mccawpa01,SG,23,TOT,29,1,397,26,63,0.413,9,28,0.321,17,35,0.486,0.484,13,15,0.867,7,41,48,29,23,2,17,38,74
331,Patrick McCaw\mccawpa01,SG,23,CLE,3,0,53,2,9,0.222,1,4,0.25,1,5,0.2,0.278,0,0,,0,3,3,2,2,0,3,1,5
331,Patrick McCaw\mccawpa01,SG,23,TOR,26,1,344,24,54,0.444,8,24,0.333,16,30,0.533,0.519,13,15,0.867,7,38,45,27,21,2,14,37,69
358,Jaylen Morris\morrija01,SG,23,MIL,4,0,29,4,10,0.4,1,3,0.333,3,7,0.429,0.45,1,2,0.5,0,5,5,4,2,0,1,1,10
401,Theo Pinson\pinsoth01,SG,23,BRK,17,0,192,23,66,0.348,12,42,0.286,11,24,0.458,0.439,19,22,0.864,2,30,32,19,5,0,15,13,77
416,Davon Reed\reedda01,SG,23,IND,9,0,24,2,4,0.5,1,1,1.0,1,3,0.333,0.625,0,0,,1,1,2,2,0,0,1,1,5
417,Cameron Reynolds\reynoca01,SG,23,MIN,17,0,214,23,57,0.404,14,37,0.378,9,20,0.45,0.526,8,9,0.889,4,20,24,11,5,2,4,22,68
419,Malachi Richardson\richama01,SG,23,TOR,22,0,103,9,29,0.31,8,25,0.32,1,4,0.25,0.448,4,5,0.8,2,11,13,0,1,0,8,13,30
468,Jared Terrell\terreja01,SG,23,MIN,12,0,89,10,32,0.313,4,13,0.308,6,19,0.316,0.375,1,2,0.5,1,4,5,9,3,1,9,13,25
480,Allonzo Trier\trieral01,SG,23,NYK,64,3,1459,232,518,0.448,52,132,0.394,180,386,0.466,0.498,179,223,0.803,31,166,197,119,28,14,116,117,695
45,DeAndre' Bembry\bembrde01,SG,24,ATL,81,15,1911,271,609,0.445,50,172,0.291,221,437,0.506,0.486,84,133,0.632,53,303,356,201,104,41,141,185,676
144,Damyean Dotson\dotsoda01,SG,24,NYK,71,38,1934,283,680,0.416,123,333,0.369,160,347,0.461,0.507,73,98,0.745,34,221,255,128,58,10,68,133,762
179,Billy Garrett\garrebi01,SG,24,NYK,2,0,37,5,13,0.385,0,4,0.0,5,9,0.556,0.385,2,2,1.0,0,1,1,4,1,1,1,2,12
210,Gary Harris\harriga01,SG,24,DEN,55,46,1579,258,611,0.422,81,236,0.343,177,375,0.472,0.489,111,139,0.799,39,118,157,124,53,18,65,106,708
330,Tahjere McCall\mccalta01,SG,24,BRK,1,0,8,2,3,0.667,0,1,0.0,2,2,1.0,0.667,0,1,0.0,0,1,1,0,0,0,0,2,4
440,Wayne Selden\seldewa01,SG,24,TOT,73,11,1391,190,467,0.407,53,167,0.317,137,300,0.457,0.464,67,90,0.744,36,130,166,104,33,13,77,130,500
440,Wayne Selden\seldewa01,SG,24,MEM,32,0,455,65,161,0.404,20,63,0.317,45,98,0.459,0.466,22,29,0.759,16,28,44,36,10,6,23,48,172
440,Wayne Selden\seldewa01,SG,24,CHI,41,11,936,125,306,0.408,33,104,0.317,92,202,0.455,0.462,45,61,0.738,20,102,122,68,23,7,54,82,328
450,Marcus Smart\smartma01,SG,24,BOS,80,60,2200,239,567,0.422,126,346,0.364,113,221,0.511,0.533,104,129,0.806,57,177,234,321,143,28,123,201,708
476,Sindarius Thornwell\thornsi01,SG,24,LAC,63,1,305,17,49,0.347,3,15,0.2,14,34,0.412,0.378,23,32,0.719,5,38,43,18,14,7,20,40,60
1,Alex Abrines\abrinal01,SG,25,OKC,31,2,588,56,157,0.357,41,127,0.323,15,30,0.5,0.487,12,13,0.923,5,43,48,20,17,6,14,53,165
7,DeVaughn Akoon-Purcell\akoonde01,SG,25,DEN,7,0,22,3,10,0.3,0,4,0.0,3,6,0.5,0.3,1,2,0.5,1,3,4,6,2,0,2,4,7
28,Ron Baker\bakerro01,SG,25,TOT,15,0,152,4,20,0.2,1,13,0.077,3,7,0.429,0.225,5,6,0.833,1,10,11,15,6,1,5,18,14
28,Ron Baker\bakerro01,SG,25,NYK,11,0,107,4,16,0.25,1,9,0.111,3,7,0.429,0.281,5,6,0.833,1,6,7,13,5,0,3,16,14
28,Ron Baker\bakerro01,SG,25,WAS,4,0,45,0,4,0.0,0,4,0.0,0,0,,0.0,0,0,,0,4,4,2,1,1,2,2,0
40,Bradley Beal\bealbr01,SG,25,WAS,81,81,3011,758,1598,0.474,207,592,0.35,551,1006,0.548,0.539,360,446,0.807,87,319,406,444,121,58,224,226,2083
83,Deonte Burton\burtode02,SG,25,OKC,31,0,239,33,82,0.402,8,27,0.296,25,55,0.455,0.451,8,12,0.667,4,24,28,9,6,8,9,31,82
87,Kentavious Caldwell-Pope\caldwke01,SG,25,LAL,81,22,1991,314,725,0.433,146,420,0.348,168,305,0.551,0.534,132,151,0.874,48,185,233,102,72,13,63,135,906
169,Bryn Forbes\forbebr01,SG,25,SAS,81,80,2266,358,783,0.457,173,407,0.425,185,376,0.492,0.568,68,77,0.883,18,217,235,173,44,4,80,158,957
193,Treveon Graham\grahatr01,SG,25,BRK,34,20,689,60,174,0.345,35,117,0.299,25,57,0.439,0.445,18,22,0.818,21,84,105,33,13,7,17,68,173
204,Dusty Hannahs\hannadu01,SG,25,MEM,2,0,26,3,12,0.25,0,5,0.0,3,7,0.429,0.25,2,2,1.0,0,1,1,5,1,0,1,1,8
338,Ben McLemore\mclembe01,SG,25,SAC,19,0,158,25,64,0.391,17,41,0.415,8,23,0.348,0.523,8,12,0.667,3,14,17,4,6,3,5,22,75
353,Naz Mitrou-Long\mitrona01,SG,25,UTA,12,0,49,3,11,0.273,1,7,0.143,2,4,0.5,0.318,0,0,,0,2,2,6,0,0,4,5,7
409,Norman Powell\powelno01,SG,25,TOR,59,3,1106,189,390,0.485,66,166,0.398,123,224,0.549,0.569,62,75,0.827,16,118,134,89,38,13,64,93,506
418,Josh Richardson\richajo01,SG,25,MIA,73,73,2539,423,1026,0.412,164,460,0.357,259,566,0.458,0.492,199,231,0.861,54,209,263,298,79,34,113,200,1209
459,Nik Stauskas\stausni01,SG,25,TOT,67,0,1003,135,335,0.403,69,187,0.369,66,148,0.446,0.506,57,64,0.891,18,108,126,81,21,7,50,50,396
459,Nik Stauskas\stausni01,SG,25,POR,44,0,673,96,229,0.419,43,125,0.344,53,104,0.51,0.513,32,36,0.889,10,70,80,62,14,4,40,31,267
459,Nik Stauskas\stausni01,SG,25,CLE,23,0,330,39,106,0.368,26,62,0.419,13,44,0.295,0.491,25,28,0.893,8,38,46,19,7,3,10,19,129
12,Kadeem Allen\allenka01,SG,26,NYK,18,1,387,62,131,0.473,15,33,0.455,47,98,0.48,0.531,37,46,0.804,8,38,46,68,14,3,26,45,176
56,Bogdan Bogdanovic\bogdabo01,SG,26,SAC,69,17,1920,356,847,0.42,131,361,0.363,225,486,0.463,0.498,132,160,0.825,40,202,242,266,72,15,116,142,975
70,Malcolm Brogdon\brogdma01,SG,26,MIL,64,64,1832,378,748,0.505,104,244,0.426,274,504,0.544,0.575,141,152,0.928,65,223,288,205,46,13,91,102,1001
107,Jordan Clarkson\clarkjo01,SG,26,CLE,80,0,2191,522,1167,0.447,142,441,0.322,380,726,0.523,0.508,162,192,0.844,80,188,268,193,57,13,133,110,1348
113,Pat Connaughton\connapa01,SG,26,MIL,60,2,1243,158,340,0.465,64,195,0.328,94,145,0.648,0.559,29,40,0.725,58,195,253,121,32,25,31,79,409
117,Allen Crabbe\crabbal01,SG,26,BRK,43,20,1133,137,373,0.367,98,259,0.378,39,114,0.342,0.499,41,56,0.732,16,132,148,46,23,13,46,102,413
170,Evan Fournier\fournev01,SG,26,ORL,80,80,2522,462,1054,0.438,153,445,0.344,309,609,0.507,0.511,135,167,0.808,38,218,256,292,71,12,154,224,1212
205,Tim Hardaway\hardati02,SG,26,TOT,65,63,2057,390,993,0.393,162,477,0.34,228,516,0.442,0.474,232,276,0.841,33,189,222,159,54,8,105,141,1174
205,Tim Hardaway\hardati02,SG,26,NYK,46,46,1499,282,726,0.388,117,337,0.347,165,389,0.424,0.469,199,233,0.854,26,135,161,122,42,6,81,106,880
205,Tim Hardaway\hardati02,SG,26,DAL,19,17,558,108,267,0.404,45,140,0.321,63,127,0.496,0.489,33,43,0.767,7,54,61,37,12,2,24,35,294
224,Buddy Hield\hieldbu01,SG,26,SAC,81,81,2599,620,1354,0.458,275,646,0.426,345,708,0.487,0.559,171,193,0.886,105,304,409,203,58,33,145,202,1686
235,Rodney Hood\hoodro01,SG,26,TOT,71,49,1872,292,665,0.439,84,234,0.359,208,431,0.483,0.502,137,155,0.884,25,130,155,125,59,11,55,145,805
235,Rodney Hood\hoodro01,SG,26,CLE,45,45,1234,194,454,0.427,55,152,0.362,139,302,0.46,0.488,104,114,0.912,18,94,112,92,38,5,36,101,547
235,Rodney Hood\hoodro01,SG,26,POR,26,4,638,98,211,0.464,29,82,0.354,69,129,0.535,0.533,33,41,0.805,7,36,43,33,21,6,19,44,258
292,Jeremy Lamb\lambje01,SG,26,CHO,77,55,2191,416,954,0.436,108,317,0.341,308,637,0.484,0.493,223,252,0.885,65,358,423,165,85,31,78,137,1163
297,Damion Lee\leeda03,SG,26,GSW,30,0,325,45,104,0.433,22,57,0.386,23,47,0.489,0.538,16,19,0.842,7,45,52,10,12,0,10,28,128
307,Zach Lofton\loftoza01,SG,26,DET,1,0,4,0,1,0.0,0,1,0.0,0,0,,0.0,0,0,,0,0,0,0,1,0,1,0,0
380,David Nwaba\nwabada01,SG,26,CLE,50,14,969,126,261,0.483,24,75,0.32,102,186,0.548,0.529,58,85,0.682,41,117,158,54,36,17,28,101,334
387,Victor Oladipo\oladivi01,SG,26,IND,36,36,1147,249,588,0.423,74,216,0.343,175,372,0.47,0.486,103,141,0.73,21,181,202,186,60,11,82,72,675
420,Austin Rivers\riverau01,SG,26,TOT,75,15,2007,231,568,0.407,103,323,0.319,128,245,0.522,0.497,50,95,0.526,25,134,159,166,46,23,68,206,615
420,Austin Rivers\riverau01,SG,26,WAS,29,2,683,76,194,0.392,33,106,0.311,43,88,0.489,0.477,25,46,0.543,10,61,71,58,18,10,36,72,210
420,Austin Rivers\riverau01,SG,26,HOU,46,13,1324,155,374,0.414,70,217,0.323,85,157,0.541,0.508,25,49,0.51,15,73,88,108,28,13,32,134,405
445,Jordan Sibert\siberjo01,SG,26,ATL,1,0,4,1,1,1.0,1,1,1.0,0,0,,1.5,0,0,,0,0,0,0,0,0,0,0,3
80,Reggie Bullock\bullore01,SG,27,TOT,63,60,1879,245,594,0.412,148,393,0.377,97,201,0.483,0.537,73,85,0.859,22,151,173,129,40,12,65,109,711
80,Reggie Bullock\bullore01,SG,27,DET,44,44,1355,182,441,0.413,114,294,0.388,68,147,0.463,0.542,56,64,0.875,20,103,123,109,24,5,54,79,534
80,Reggie Bullock\bullore01,SG,27,LAL,19,16,524,63,153,0.412,34,99,0.343,29,54,0.537,0.523,17,21,0.81,2,48,50,20,16,7,11,30,177
82,Alec Burks\burksal01,SG,27,TOT,64,24,1375,192,474,0.405,61,168,0.363,131,306,0.428,0.469,116,141,0.823,30,205,235,128,39,21,65,91,561
82,Alec Burks\burksal01,SG,27,UTA,17,0,269,47,114,0.412,16,43,0.372,31,71,0.437,0.482,33,38,0.868,2,25,27,20,6,4,15,22,143
82,Alec Burks\burksal01,SG,27,CLE,34,24,979,136,340,0.4,45,119,0.378,91,221,0.412,0.466,79,98,0.806,26,160,186,98,25,16,46,62,396
82,Alec Burks\burksal01,SG,27,SAC,13,0,127,9,20,0.45,0,6,0.0,9,14,0.643,0.45,4,5,0.8,2,20,22,10,8,1,4,7,22
106,Ian Clark\clarkia01,SG,27,NOP,59,5,934,143,361,0.396,63,192,0.328,80,169,0.473,0.483,32,36,0.889,13,75,88,90,21,8,57,92,381
125,Troy Daniels\danietr01,SG,27,PHO,50,1,750,113,272,0.415,74,192,0.385,39,80,0.488,0.551,18,23,0.783,13,60,73,26,25,5,27,77,318
178,Langston Galloway\gallola01,SG,27,DET,78,4,1700,223,571,0.391,132,370,0.357,91,201,0.453,0.506,79,94,0.84,47,117,164,83,36,8,24,132,657
211,Joe Harris\harrijo01,SG,27,BRK,76,76,2293,374,748,0.5,183,386,0.474,191,362,0.528,0.622,110,133,0.827,52,239,291,181,38,17,121,182,1041
259,John Jenkins\jenkijo01,SG,27,TOT,24,0,285,33,89,0.371,17,49,0.347,16,40,0.4,0.466,13,15,0.867,4,24,28,19,0,2,9,6,96
259,John Jenkins\jenkijo01,SG,27,WAS,4,0,14,2,2,1.0,2,2,1.0,0,0,,1.5,0,0,,0,1,1,1,0,0,0,0,6
259,John Jenkins\jenkijo01,SG,27,NYK,20,0,271,31,87,0.356,15,47,0.319,16,40,0.4,0.443,13,15,0.867,4,23,27,18,0,2,9,6,90
332,CJ McCollum\mccolcj01,SG,27,POR,69,69,2346,566,1230,0.46,166,439,0.378,400,791,0.506,0.528,159,191,0.832,62,219,281,204,55,27,104,169,1457
336,Rodney McGruder\mcgruro01,SG,27,MIA,66,45,1550,186,461,0.403,79,225,0.351,107,236,0.453,0.489,52,72,0.722,60,178,238,112,36,12,64,115,503
339,Jordan McRae\mcraejo01,SG,27,WAS,27,0,333,61,130,0.469,10,35,0.286,51,95,0.537,0.508,28,35,0.8,6,34,40,30,13,7,15,26,160
428,Terrence Ross\rosste01,SG,27,ORL,80,0,2120,428,1008,0.425,211,556,0.379,217,452,0.48,0.529,121,139,0.871,25,249,274,133,71,29,89,118,1188
493,Dion Waiters\waitedi01,SG,27,MIA,42,28,1112,195,468,0.417,107,284,0.377,88,184,0.478,0.531,22,44,0.5,7,106,113,118,29,8,64,70,519
34,Will Barton\bartowi01,SG,28,DEN,41,36,1135,181,447,0.405,66,191,0.346,115,256,0.449,0.479,56,72,0.778,31,157,188,118,17,21,64,81,484
63,Avery Bradley\bradlav01,SG,28,TOT,63,63,1905,248,608,0.408,86,245,0.351,162,363,0.446,0.479,43,50,0.86,43,132,175,152,41,16,89,167,625
63,Avery Bradley\bradlav01,SG,28,LAC,49,49,1463,161,420,0.383,58,172,0.337,103,248,0.415,0.452,20,25,0.8,35,96,131,96,27,16,61,133,400
63,Avery Bradley\bradlav01,SG,28,MEM,14,14,442,87,188,0.463,28,73,0.384,59,115,0.513,0.537,23,25,0.92,8,36,44,56,14,0,28,34,225
69,Ryan Broekhoff\broekry01,SG,28,DAL,40,0,425,56,120,0.467,37,88,0.42,19,32,0.594,0.621,15,19,0.789,8,54,62,22,4,4,12,32,164
123,Seth Curry\curryse01,SG,28,POR,73,2,1372,205,452,0.454,108,243,0.444,97,209,0.464,0.573,44,52,0.846,27,91,118,65,33,12,60,96,562
230,Jrue Holiday\holidjr01,SG,28,NOP,67,67,2402,547,1159,0.472,118,363,0.325,429,796,0.539,0.523,208,271,0.768,75,259,334,518,109,54,210,148,1420
443,Iman Shumpert\shumpim01,SG,28,TOT,62,41,1481,167,446,0.374,95,273,0.348,72,173,0.416,0.481,36,45,0.8,27,156,183,112,59,24,50,127,465
443,Iman Shumpert\shumpim01,SG,28,SAC,42,40,1099,133,348,0.382,74,202,0.366,59,146,0.404,0.489,34,41,0.829,19,110,129,91,47,20,38,92,374
443,Iman Shumpert\shumpim01,SG,28,HOU,20,1,382,34,98,0.347,21,71,0.296,13,27,0.481,0.454,2,4,0.5,8,46,54,21,12,4,12,35,91
460,D.J. Stephens\stephdj01,SG,28,MEM,1,0,7,1,2,0.5,0,0,,1,2,0.5,0.5,0,0,,0,0,0,0,1,0,1,0,2
461,Lance Stephenson\stephla01,SG,28,LAL,68,3,1123,184,432,0.426,73,197,0.371,111,235,0.472,0.51,50,73,0.685,32,183,215,140,41,7,86,111,491
474,Klay Thompson\thompkl01,SG,28,GSW,77,77,2635,647,1390,0.465,238,594,0.401,409,796,0.514,0.551,129,158,0.816,37,261,298,183,83,46,115,157,1661
510,C.J. Williams\willicj01,SG,28,MIN,13,0,92,12,27,0.444,2,12,0.167,10,15,0.667,0.481,0,0,,1,4,5,11,3,0,4,13,26
39,Kent Bazemore\bazemke01,SG,29,ATL,66,35,1626,276,681,0.405,94,294,0.32,182,387,0.47,0.474,126,173,0.728,37,222,259,150,89,42,120,168,772
47,Dairis Bertans\bertada02,SG,29,NOP,11,0,141,12,43,0.279,10,32,0.313,2,11,0.182,0.395,0,0,,2,7,9,8,1,0,2,6,34
84,Jimmy Butler\butleji01,SG,29,MIN,10,10,361,74,157,0.471,17,45,0.378,57,112,0.509,0.525,48,61,0.787,16,36,52,43,24,10,14,18,213
135,DeMar DeRozan\derozde01,SG,29,SAS,76,76,2654,624,1298,0.481,7,44,0.159,617,1254,0.492,0.483,361,435,0.83,53,404,457,471,83,36,197,175,1616
160,Tyreke Evans\evansty01,SG,29,IND,68,17,1376,248,646,0.384,72,208,0.346,176,438,0.402,0.44,111,155,0.716,33,166,199,161,58,18,115,113,679
174,Jimmer Fredette\fredeji01,SG,29,PHO,5,0,51,8,26,0.308,0,11,0.0,8,15,0.533,0.308,6,6,1.0,1,4,5,4,3,0,4,5,22
231,Justin Holiday\holidju01,SG,29,TOT,80,75,2543,289,753,0.384,155,450,0.344,134,303,0.442,0.487,94,104,0.904,45,270,315,143,120,34,100,161,827
231,Justin Holiday\holidju01,SG,29,CHI,38,38,1325,151,394,0.383,97,270,0.359,54,124,0.435,0.506,41,46,0.891,19,150,169,85,67,21,47,79,440
231,Justin Holiday\holidju01,SG,29,MEM,42,37,1218,138,359,0.384,58,180,0.322,80,179,0.447,0.465,53,58,0.914,26,120,146,58,53,13,53,82,387
356,E'Twaun Moore\mooreet01,SG,29,NOP,53,36,1463,256,532,0.481,76,176,0.432,180,356,0.506,0.553,45,59,0.763,35,92,127,102,40,8,59,112,633
447,Jonathon Simmons\simmojo02,SG,29,ORL,41,9,845,104,286,0.364,19,83,0.229,85,203,0.419,0.397,56,72,0.778,23,77,100,95,18,14,56,68,283
471,Isaiah Thomas\thomais02,SG,29,DEN,12,0,181,34,99,0.343,12,43,0.279,22,56,0.393,0.404,17,27,0.63,5,8,13,23,5,1,18,17,97
72,MarShon Brooks\brookma01,SG,30,MEM,29,0,387,76,169,0.45,15,54,0.278,61,115,0.53,0.494,23,33,0.697,12,33,45,25,9,4,21,33,190
190,Eric Gordon\gordoer01,SG,30,HOU,67,52,2128,381,926,0.411,214,591,0.362,167,335,0.499,0.527,119,152,0.783,17,130,147,126,40,26,89,141,1095
154,Wayne Ellington\ellinwa01,SG,31,TOT,51,36,1241,179,437,0.41,134,357,0.375,45,80,0.563,0.563,34,44,0.773,14,90,104,69,51,6,38,90,526
154,Wayne Ellington\ellinwa01,SG,31,MIA,25,12,533,69,184,0.375,57,155,0.368,12,29,0.414,0.53,14,16,0.875,6,41,47,29,24,3,14,40,209
154,Wayne Ellington\ellinwa01,SG,31,DET,26,24,708,110,253,0.435,77,202,0.381,33,51,0.647,0.587,20,28,0.714,8,49,57,40,27,3,24,50,317
197,Danny Green\greenda02,SG,31,TOR,79,79,2192,291,625,0.466,197,432,0.456,94,193,0.487,0.623,35,42,0.833,60,255,315,122,72,52,74,171,814
340,Jodie Meeks\meeksjo01,SG,31,TOR,7,0,86,18,34,0.529,7,15,0.467,11,19,0.579,0.632,1,1,1.0,1,10,11,7,1,1,1,4,44
43,Marco Belinelli\belinma01,SG,32,SAS,78,1,1798,284,684,0.415,147,393,0.374,137,291,0.471,0.523,112,124,0.903,16,180,196,131,35,8,71,120,827
328,Wesley Matthews\matthwe02,SG,32,NYK,2,1,54,4,19,0.211,2,10,0.2,2,9,0.222,0.263,4,5,0.8,1,2,3,5,1,1,2,2,14
328,Wesley Matthews\matthwe02,SG,32,IND,23,23,725,81,210,0.386,48,130,0.369,33,80,0.413,0.5,41,48,0.854,11,54,65,55,20,4,31,56,251
466,Garrett Temple\templga01,SG,32,TOT,74,55,2019,207,488,0.424,89,261,0.341,118,227,0.52,0.515,78,105,0.743,27,187,214,106,73,30,70,202,581
466,Garrett Temple\templga01,SG,32,MEM,49,49,1530,166,387,0.429,74,210,0.352,92,177,0.52,0.525,57,76,0.75,18,134,152,69,50,25,54,134,463
466,Garrett Temple\templga01,SG,32,LAC,25,6,489,41,101,0.406,15,51,0.294,26,50,0.52,0.48,21,29,0.724,9,53,62,37,23,5,16,68,118
513,Lou Williams\willilo02,SG,32,LAC,74,1,1970,479,1121,0.427,104,289,0.36,375,832,0.451,0.474,421,480,0.877,38,179,217,397,57,11,178,80,1483
199,Gerald Green\greenge01,SG,33,HOU,72,0,1458,226,569,0.397,151,432,0.35,75,137,0.547,0.53,57,68,0.838,30,152,182,40,32,27,55,125,660
246,Andre Ingram\ingraan01,SG,33,LAL,4,0,15,0,6,0.0,0,3,0.0,0,3,0.0,0.0,0,0,,1,1,2,0,1,0,1,0,0
296,Courtney Lee\leeco01,SG,33,TOT,33,6,408,47,120,0.392,14,51,0.275,33,69,0.478,0.45,14,21,0.667,9,42,51,35,20,3,13,31,122
296,Courtney Lee\leeco01,SG,33,NYK,12,2,160,21,47,0.447,5,16,0.313,16,31,0.516,0.5,9,14,0.643,6,21,27,16,8,2,5,13,56
296,Courtney Lee\leeco01,SG,33,DAL,21,4,248,26,73,0.356,9,35,0.257,17,38,0.447,0.418,5,7,0.714,3,21,24,19,12,1,8,18,66
453,J.R. Smith\smithjr01,SG,33,CLE,11,4,222,27,79,0.342,12,39,0.308,15,40,0.375,0.418,8,10,0.8,0,18,18,21,11,3,11,19,74
522,Nick Young\youngni01,SG,33,DEN,4,0,37,3,9,0.333,3,8,0.375,0,1,0.0,0.5,0,0,,0,1,1,2,0,1,2,4,9
415,J.J. Redick\redicjj01,SG,34,PHI,76,63,2379,452,1027,0.44,240,605,0.397,212,422,0.502,0.557,228,255,0.894,20,166,186,206,32,17,101,129,1372
287,Kyle Korver\korveky01,SG,37,UTA,54,0,1083,166,407,0.408,113,294,0.384,53,113,0.469,0.547,47,57,0.825,9,124,133,64,22,10,42,84,492
491,Dwyane Wade\wadedw01,SG,37,MIA,70,0,1814,396,909,0.436,79,238,0.332,317,671,0.472,0.479,157,224,0.701,67,204,271,288,59,36,160,116,1028
119,Jamal Crawford\crawfja01,SG,38,PHO,63,0,1173,156,408,0.382,60,189,0.317,96,219,0.438,0.456,85,101,0.842,8,72,80,224,32,11,95,71,457
